ATCACGCAATT -> TCACGCAATTA
TCACGCAATTA -> CACGCAATTAG
CACGCAATTAG -> ACGCAATTAGG
ACGCAATTAGG -> CGCAATTAGGT
CGCAATTAGGT -> GCAATTAGGTC
GCAATTAGGTC -> CAATTAGGTCG
CAATTAGGTCG -> AATTAGGTCGT
AATTAGGTCGT -> ATTAGGTCGTG
ATTAGGTCGTG -> TTAGGTCGTGC
TTAGGTCGTGC -> TAGGTCGTGCT
TAGGTCGTGCT -> AGGTCGTGCTA
AGGTCGTGCTA -> GGTCGTGCTAA
GGTCGTGCTAA -> GTCGTGCTAAG
GTCGTGCTAAG -> TCGTGCTAAGT
TCGTGCTAAGT -> CGTGCTAAGTC
CGTGCTAAGTC -> GTGCTAAGTCT
GTGCTAAGTCT -> TGCTAAGTCTC
TGCTAAGTCTC -> GCTAAGTCTCA
GCTAAGTCTCA -> CTAAGTCTCAG
CTAAGTCTCAG -> TAAGTCTCAGG
TAAGTCTCAGG -> AAGTCTCAGGA
AAGTCTCAGGA -> AGTCTCAGGAG
AGTCTCAGGAG -> GTCTCAGGAGT
GTCTCAGGAGT -> TCTCAGGAGTT
TCTCAGGAGTT -> CTCAGGAGTTT
CTCAGGAGTTT -> TCAGGAGTTTG
TCAGGAGTTTG -> CAGGAGTTTGT
CAGGAGTTTGT -> AGGAGTTTGTG
AGGAGTTTGTG -> GGAGTTTGTGA
GGAGTTTGTGA -> GAGTTTGTGAG
GAGTTTGTGAG -> AGTTTGTGAGG
AGTTTGTGAGG -> GTTTGTGAGGA
GTTTGTGAGGA -> TTTGTGAGGAT
TTTGTGAGGAT -> TTGTGAGGATA
TTGTGAGGATA -> TGTGAGGATAC
TGTGAGGATAC -> GTGAGGATACG
GTGAGGATACG -> TGAGGATACGC
TGAGGATACGC -> GAGGATACGCA
GAGGATACGCA -> AGGATACGCAG
AGGATACGCAG -> GGATACGCAGT
GGATACGCAGT -> GATACGCAGTG
GATACGCAGTG -> ATACGCAGTGT
ATACGCAGTGT -> TACGCAGTGTC
TACGCAGTGTC -> ACGCAGTGTCC
ACGCAGTGTCC -> CGCAGTGTCCC
CGCAGTGTCCC -> GCAGTGTCCCT
GCAGTGTCCCT -> CAGTGTCCCTT, CAGTGTCCCTA
CAGTGTCCCTT -> AGTGTCCCTTG
AGTGTCCCTTG -> GTGTCCCTTGC
GTGTCCCTTGC -> TGTCCCTTGCC
TGTCCCTTGCC -> GTCCCTTGCCA
GTCCCTTGCCA -> TCCCTTGCCAT
TCCCTTGCCAT -> CCCTTGCCATC
CCCTTGCCATC -> CCTTGCCATCA
CCTTGCCATCA -> CTTGCCATCAC
CTTGCCATCAC -> TTGCCATCACA
TTGCCATCACA -> TGCCATCACAC
TGCCATCACAC -> GCCATCACACC
GCCATCACACC -> CCATCACACCC
CCATCACACCC -> CATCACACCCT
CATCACACCCT -> ATCACACCCTA
ATCACACCCTA -> TCACACCCTAT
TCACACCCTAT -> CACACCCTATG
CACACCCTATG -> ACACCCTATGG
ACACCCTATGG -> CACCCTATGGC
CACCCTATGGC -> ACCCTATGGCA
ACCCTATGGCA -> CCCTATGGCAT
CCCTATGGCAT -> CCTATGGCATT
CCTATGGCATT -> CTATGGCATTG
CTATGGCATTG -> TATGGCATTGG
TATGGCATTGG -> ATGGCATTGGT
ATGGCATTGGT -> TGGCATTGGTC
TGGCATTGGTC -> GGCATTGGTCC
GGCATTGGTCC -> GCATTGGTCCT
GCATTGGTCCT -> CATTGGTCCTC
CATTGGTCCTC -> ATTGGTCCTCC
ATTGGTCCTCC -> TTGGTCCTCCG
TTGGTCCTCCG -> TGGTCCTCCGC
TGGTCCTCCGC -> GGTCCTCCGCG
GGTCCTCCGCG -> GTCCTCCGCGT
GTCCTCCGCGT -> TCCTCCGCGTG
TCCTCCGCGTG -> CCTCCGCGTGC
CCTCCGCGTGC -> CTCCGCGTGCT
CTCCGCGTGCT -> TCCGCGTGCTC
TCCGCGTGCTC -> CCGCGTGCTCG
CCGCGTGCTCG -> CGCGTGCTCGC
CGCGTGCTCGC -> GCGTGCTCGCC
GCGTGCTCGCC -> CGTGCTCGCCG
CGTGCTCGCCG -> GTGCTCGCCGA
GTGCTCGCCGA -> TGCTCGCCGAA
TGCTCGCCGAA -> GCTCGCCGAAT
GCTCGCCGAAT -> CTCGCCGAATC
CTCGCCGAATC -> TCGCCGAATCG
TCGCCGAATCG -> CGCCGAATCGG
CGCCGAATCGG -> GCCGAATCGGC
GCCGAATCGGC -> CCGAATCGGCG
CCGAATCGGCG -> CGAATCGGCGA
CGAATCGGCGA -> GAATCGGCGAG
GAATCGGCGAG -> AATCGGCGAGT
AATCGGCGAGT -> ATCGGCGAGTC
ATCGGCGAGTC -> TCGGCGAGTCC
TCGGCGAGTCC -> CGGCGAGTCCG
CGGCGAGTCCG -> GGCGAGTCCGT
GGCGAGTCCGT -> GCGAGTCCGTC
GCGAGTCCGTC -> CGAGTCCGTCT
CGAGTCCGTCT -> GAGTCCGTCTA
GAGTCCGTCTA -> AGTCCGTCTAC
AGTCCGTCTAC -> GTCCGTCTACG
GTCCGTCTACG -> TCCGTCTACGG
TCCGTCTACGG -> CCGTCTACGGA
CCGTCTACGGA -> CGTCTACGGAA
CGTCTACGGAA -> GTCTACGGAAT
GTCTACGGAAT -> TCTACGGAATG
TCTACGGAATG -> CTACGGAATGC
CTACGGAATGC -> TACGGAATGCC
TACGGAATGCC -> ACGGAATGCCG
ACGGAATGCCG -> CGGAATGCCGA
CGGAATGCCGA -> GGAATGCCGAC
GGAATGCCGAC -> GAATGCCGACG
GAATGCCGACG -> AATGCCGACGG
AATGCCGACGG -> ATGCCGACGGT
ATGCCGACGGT -> TGCCGACGGTG
TGCCGACGGTG -> GCCGACGGTGC
GCCGACGGTGC -> CCGACGGTGCA
CCGACGGTGCA -> CGACGGTGCAC
CGACGGTGCAC -> GACGGTGCACG
GACGGTGCACG -> ACGGTGCACGT
ACGGTGCACGT -> CGGTGCACGTA
CGGTGCACGTA -> GGTGCACGTAG
GGTGCACGTAG -> GTGCACGTAGA
GTGCACGTAGA -> TGCACGTAGAC
TGCACGTAGAC -> GCACGTAGACT
GCACGTAGACT -> CACGTAGACTT
CACGTAGACTT -> ACGTAGACTTT
ACGTAGACTTT -> CGTAGACTTTC
CGTAGACTTTC -> GTAGACTTTCT
GTAGACTTTCT -> TAGACTTTCTT
TAGACTTTCTT -> AGACTTTCTTA
AGACTTTCTTA -> GACTTTCTTAA
GACTTTCTTAA -> ACTTTCTTAAG
ACTTTCTTAAG -> CTTTCTTAAGA
CTTTCTTAAGA -> TTTCTTAAGAG
TTTCTTAAGAG -> TTCTTAAGAGA
TTCTTAAGAGA -> TCTTAAGAGAG
TCTTAAGAGAG -> CTTAAGAGAGA
CTTAAGAGAGA -> TTAAGAGAGAC
TTAAGAGAGAC -> TAAGAGAGACA
TAAGAGAGACA -> AAGAGAGACAC
AAGAGAGACAC -> AGAGAGACACC
AGAGAGACACC -> GAGAGACACCA
GAGAGACACCA -> AGAGACACCAA
AGAGACACCAA -> GAGACACCAAG
GAGACACCAAG -> AGACACCAAGC
AGACACCAAGC -> GACACCAAGCT
GACACCAAGCT -> ACACCAAGCTT
ACACCAAGCTT -> CACCAAGCTTG
CACCAAGCTTG -> ACCAAGCTTGC
ACCAAGCTTGC -> CCAAGCTTGCG
CCAAGCTTGCG -> CAAGCTTGCGC
CAAGCTTGCGC -> AAGCTTGCGCT
AAGCTTGCGCT -> AGCTTGCGCTT
AGCTTGCGCTT -> GCTTGCGCTTG
GCTTGCGCTTG -> CTTGCGCTTGG
CTTGCGCTTGG -> TTGCGCTTGGA
TTGCGCTTGGA -> TGCGCTTGGAG
TGCGCTTGGAG -> GCGCTTGGAGA
GCGCTTGGAGA -> CGCTTGGAGAG
CGCTTGGAGAG -> GCTTGGAGAGC
GCTTGGAGAGC -> CTTGGAGAGCG
CTTGGAGAGCG -> TTGGAGAGCGC
TTGGAGAGCGC -> TGGAGAGCGCA
TGGAGAGCGCA -> GGAGAGCGCAT
GGAGAGCGCAT -> GAGAGCGCATT
GAGAGCGCATT -> AGAGCGCATTG
AGAGCGCATTG -> GAGCGCATTGT
GAGCGCATTGT -> AGCGCATTGTC
AGCGCATTGTC -> GCGCATTGTCC
GCGCATTGTCC -> CGCATTGTCCC
CGCATTGTCCC -> GCATTGTCCCT
GCATTGTCCCT -> CATTGTCCCTT
CATTGTCCCTT -> ATTGTCCCTTG
ATTGTCCCTTG -> TTGTCCCTTGT
TTGTCCCTTGT -> TGTCCCTTGTA
TGTCCCTTGTA -> GTCCCTTGTAT
GTCCCTTGTAT -> TCCCTTGTATA
TCCCTTGTATA -> CCCTTGTATAT
CCCTTGTATAT -> CCTTGTATATG
CCTTGTATATG -> CTTGTATATGG
CTTGTATATGG -> TTGTATATGGC
TTGTATATGGC -> TGTATATGGCG
TGTATATGGCG -> GTATATGGCGC
GTATATGGCGC -> TATATGGCGCG
TATATGGCGCG -> ATATGGCGCGA
ATATGGCGCGA -> TATGGCGCGAC
TATGGCGCGAC -> ATGGCGCGACC
ATGGCGCGACC -> TGGCGCGACCA
TGGCGCGACCA -> GGCGCGACCAT
GGCGCGACCAT -> GCGCGACCATC
GCGCGACCATC -> CGCGACCATCT
CGCGACCATCT -> GCGACCATCTT
GCGACCATCTT -> CGACCATCTTT
CGACCATCTTT -> GACCATCTTTG
GACCATCTTTG -> ACCATCTTTGT
ACCATCTTTGT -> CCATCTTTGTG
CCATCTTTGTG -> CATCTTTGTGA
CATCTTTGTGA -> ATCTTTGTGAC
ATCTTTGTGAC -> TCTTTGTGACT
TCTTTGTGACT -> CTTTGTGACTG
CTTTGTGACTG -> TTTGTGACTGA
TTTGTGACTGA -> TTGTGACTGAA
TTGTGACTGAA -> TGTGACTGAAT
TGTGACTGAAT -> GTGACTGAATA
GTGACTGAATA -> TGACTGAATAT
TGACTGAATAT -> GACTGAATATG
GACTGAATATG -> ACTGAATATGG
ACTGAATATGG -> CTGAATATGGT
CTGAATATGGT -> TGAATATGGTA
TGAATATGGTA -> GAATATGGTAT
GAATATGGTAT -> AATATGGTATA
AATATGGTATA -> ATATGGTATAA
ATATGGTATAA -> TATGGTATAAT
TATGGTATAAT -> ATGGTATAATA
ATGGTATAATA -> TGGTATAATAT
TGGTATAATAT -> GGTATAATATT
GGTATAATATT -> GTATAATATTT
GTATAATATTT -> TATAATATTTC
TATAATATTTC -> ATAATATTTCA
ATAATATTTCA -> TAATATTTCAA
TAATATTTCAA -> AATATTTCAAG
AATATTTCAAG -> ATATTTCAAGT
ATATTTCAAGT -> TATTTCAAGTA
TATTTCAAGTA -> ATTTCAAGTAT
ATTTCAAGTAT -> TTTCAAGTATA
TTTCAAGTATA -> TTCAAGTATAT
TTCAAGTATAT -> TCAAGTATATT
TCAAGTATATT -> CAAGTATATTT
CAAGTATATTT -> AAGTATATTTC
AAGTATATTTC -> AGTATATTTCC
AGTATATTTCC -> GTATATTTCCT
GTATATTTCCT -> TATATTTCCTA
TATATTTCCTA -> ATATTTCCTAA
ATATTTCCTAA -> TATTTCCTAAA
TATTTCCTAAA -> ATTTCCTAAAA
ATTTCCTAAAA -> TTTCCTAAAAT
TTTCCTAAAAT -> TTCCTAAAATA
TTCCTAAAATA -> TCCTAAAATAG
TCCTAAAATAG -> CCTAAAATAGA
CCTAAAATAGA -> CTAAAATAGAG
CTAAAATAGAG -> TAAAATAGAGA
TAAAATAGAGA -> AAAATAGAGAT
AAAATAGAGAT -> AAATAGAGATG
AAATAGAGATG -> AATAGAGATGC
AATAGAGATGC -> ATAGAGATGCC
ATAGAGATGCC -> TAGAGATGCCC
TAGAGATGCCC -> AGAGATGCCCA
AGAGATGCCCA -> GAGATGCCCAG
GAGATGCCCAG -> AGATGCCCAGA
AGATGCCCAGA -> GATGCCCAGAT
GATGCCCAGAT -> ATGCCCAGATA
ATGCCCAGATA -> TGCCCAGATAT
TGCCCAGATAT -> GCCCAGATATA
GCCCAGATATA -> CCCAGATATAG
CCCAGATATAG -> CCAGATATAGT
CCAGATATAGT -> CAGATATAGTG
CAGATATAGTG -> AGATATAGTGA
AGATATAGTGA -> GATATAGTGAA
GATATAGTGAA -> ATATAGTGAAC
ATATAGTGAAC -> TATAGTGAACG
TATAGTGAACG -> ATAGTGAACGC
ATAGTGAACGC -> TAGTGAACGCG
TAGTGAACGCG -> AGTGAACGCGT
AGTGAACGCGT -> GTGAACGCGTG
GTGAACGCGTG -> TGAACGCGTGT
TGAACGCGTGT -> GAACGCGTGTG
GAACGCGTGTG -> AACGCGTGTGC
AACGCGTGTGC -> ACGCGTGTGCC
ACGCGTGTGCC -> CGCGTGTGCCA
CGCGTGTGCCA -> GCGTGTGCCAG
GCGTGTGCCAG -> CGTGTGCCAGA
CGTGTGCCAGA -> GTGTGCCAGAG
GTGTGCCAGAG -> TGTGCCAGAGT
TGTGCCAGAGT -> GTGCCAGAGTA
GTGCCAGAGTA -> TGCCAGAGTAC
TGCCAGAGTAC -> GCCAGAGTACA
GCCAGAGTACA -> CCAGAGTACAG
CCAGAGTACAG -> CAGAGTACAGG
CAGAGTACAGG -> AGAGTACAGGG
AGAGTACAGGG -> GAGTACAGGGT
GAGTACAGGGT -> AGTACAGGGTT
AGTACAGGGTT -> GTACAGGGTTC
GTACAGGGTTC -> TACAGGGTTCC
TACAGGGTTCC -> ACAGGGTTCCG
ACAGGGTTCCG -> CAGGGTTCCGG
CAGGGTTCCGG -> AGGGTTCCGGT
AGGGTTCCGGT -> GGGTTCCGGTT
GGGTTCCGGTT -> GGTTCCGGTTT
GGTTCCGGTTT -> GTTCCGGTTTT
GTTCCGGTTTT -> TTCCGGTTTTG
TTCCGGTTTTG -> TCCGGTTTTGA
TCCGGTTTTGA -> CCGGTTTTGAT
CCGGTTTTGAT -> CGGTTTTGATT
CGGTTTTGATT -> GGTTTTGATTG
GGTTTTGATTG -> GTTTTGATTGC
GTTTTGATTGC -> TTTTGATTGCT
TTTTGATTGCT -> TTTGATTGCTC
TTTGATTGCTC -> TTGATTGCTCT
TTGATTGCTCT -> TGATTGCTCTG
TGATTGCTCTG -> GATTGCTCTGA
GATTGCTCTGA -> ATTGCTCTGAT
ATTGCTCTGAT -> TTGCTCTGATG
TTGCTCTGATG -> TGCTCTGATGG
TGCTCTGATGG -> GCTCTGATGGC
GCTCTGATGGC -> CTCTGATGGCC
CTCTGATGGCC -> TCTGATGGCCC
TCTGATGGCCC -> CTGATGGCCCG
CTGATGGCCCG -> TGATGGCCCGG
TGATGGCCCGG -> GATGGCCCGGT
GATGGCCCGGT -> ATGGCCCGGTC
ATGGCCCGGTC -> TGGCCCGGTCA
TGGCCCGGTCA -> GGCCCGGTCAG
GGCCCGGTCAG -> GCCCGGTCAGG
GCCCGGTCAGG -> CCCGGTCAGGG
CCCGGTCAGGG -> CCGGTCAGGGC
CCGGTCAGGGC -> CGGTCAGGGCC
CGGTCAGGGCC -> GGTCAGGGCCT
GGTCAGGGCCT -> GTCAGGGCCTC
GTCAGGGCCTC -> TCAGGGCCTCA
TCAGGGCCTCA -> CAGGGCCTCAG
CAGGGCCTCAG -> AGGGCCTCAGC
AGGGCCTCAGC -> GGGCCTCAGCC
GGGCCTCAGCC -> GGCCTCAGCCA
GGCCTCAGCCA -> GCCTCAGCCAC
GCCTCAGCCAC -> CCTCAGCCACG
CCTCAGCCACG -> CTCAGCCACGT
CTCAGCCACGT -> TCAGCCACGTA
TCAGCCACGTA -> CAGCCACGTAG
CAGCCACGTAG -> AGCCACGTAGA
AGCCACGTAGA -> GCCACGTAGAC
GCCACGTAGAC -> CCACGTAGACT
CCACGTAGACT -> CACGTAGACTA
CACGTAGACTA -> ACGTAGACTAG
ACGTAGACTAG -> CGTAGACTAGA
CGTAGACTAGA -> GTAGACTAGAG
GTAGACTAGAG -> TAGACTAGAGG
TAGACTAGAGG -> AGACTAGAGGT
AGACTAGAGGT -> GACTAGAGGTC
GACTAGAGGTC -> ACTAGAGGTCG
ACTAGAGGTCG -> CTAGAGGTCGG
CTAGAGGTCGG -> TAGAGGTCGGT
TAGAGGTCGGT -> AGAGGTCGGTA
AGAGGTCGGTA -> GAGGTCGGTAT
GAGGTCGGTAT -> AGGTCGGTATT
AGGTCGGTATT -> GGTCGGTATTT
GGTCGGTATTT -> GTCGGTATTTA
GTCGGTATTTA -> TCGGTATTTAT
TCGGTATTTAT -> CGGTATTTATT
CGGTATTTATT -> GGTATTTATTC
GGTATTTATTC -> GTATTTATTCT
GTATTTATTCT -> TATTTATTCTA
TATTTATTCTA -> ATTTATTCTAC
ATTTATTCTAC -> TTTATTCTACC
TTTATTCTACC -> TTATTCTACCA
TTATTCTACCA -> TATTCTACCAT
TATTCTACCAT -> ATTCTACCATT
ATTCTACCATT -> TTCTACCATTG
TTCTACCATTG -> TCTACCATTGA
TCTACCATTGA -> CTACCATTGAA
CTACCATTGAA -> TACCATTGAAG
TACCATTGAAG -> ACCATTGAAGT
ACCATTGAAGT -> CCATTGAAGTT
CCATTGAAGTT -> CATTGAAGTTC
CATTGAAGTTC -> ATTGAAGTTCG
ATTGAAGTTCG -> TTGAAGTTCGG
TTGAAGTTCGG -> TGAAGTTCGGC
TGAAGTTCGGC -> GAAGTTCGGCG
GAAGTTCGGCG -> AAGTTCGGCGG
AAGTTCGGCGG -> AGTTCGGCGGA
AGTTCGGCGGA -> GTTCGGCGGAA
GTTCGGCGGAA -> TTCGGCGGAAG
TTCGGCGGAAG -> TCGGCGGAAGT
TCGGCGGAAGT -> CGGCGGAAGTA
CGGCGGAAGTA -> GGCGGAAGTAT
GGCGGAAGTAT -> GCGGAAGTATA
GCGGAAGTATA -> CGGAAGTATAA
CGGAAGTATAA -> GGAAGTATAAT
GGAAGTATAAT -> GAAGTATAATC
GAAGTATAATC -> AAGTATAATCT
AAGTATAATCT -> AGTATAATCTA
AGTATAATCTA -> GTATAATCTAC
GTATAATCTAC -> TATAATCTACG
TATAATCTACG -> ATAATCTACGA
ATAATCTACGA -> TAATCTACGAG
TAATCTACGAG -> AATCTACGAGG
AATCTACGAGG -> ATCTACGAGGA
ATCTACGAGGA -> TCTACGAGGAG
TCTACGAGGAG -> CTACGAGGAGA
CTACGAGGAGA -> TACGAGGAGAT
TACGAGGAGAT -> ACGAGGAGATA
ACGAGGAGATA -> CGAGGAGATAG
CGAGGAGATAG -> GAGGAGATAGT
GAGGAGATAGT -> AGGAGATAGTC
AGGAGATAGTC -> GGAGATAGTCT
GGAGATAGTCT -> GAGATAGTCTG
GAGATAGTCTG -> AGATAGTCTGT
AGATAGTCTGT -> GATAGTCTGTC
GATAGTCTGTC -> ATAGTCTGTCA
ATAGTCTGTCA -> TAGTCTGTCAT
TAGTCTGTCAT -> AGTCTGTCATG
AGTCTGTCATG -> GTCTGTCATGT
GTCTGTCATGT -> TCTGTCATGTT
TCTGTCATGTT -> CTGTCATGTTC
CTGTCATGTTC -> TGTCATGTTCT
TGTCATGTTCT -> GTCATGTTCTT
GTCATGTTCTT -> TCATGTTCTTG
TCATGTTCTTG -> CATGTTCTTGG
CATGTTCTTGG -> ATGTTCTTGGT
ATGTTCTTGGT -> TGTTCTTGGTG
TGTTCTTGGTG -> GTTCTTGGTGC
GTTCTTGGTGC -> TTCTTGGTGCA
TTCTTGGTGCA -> TCTTGGTGCAG
TCTTGGTGCAG -> CTTGGTGCAGA
CTTGGTGCAGA -> TTGGTGCAGAA
TTGGTGCAGAA -> TGGTGCAGAAT
TGGTGCAGAAT -> GGTGCAGAATG
GGTGCAGAATG -> GTGCAGAATGA
GTGCAGAATGA -> TGCAGAATGAC
TGCAGAATGAC -> GCAGAATGACC
GCAGAATGACC -> CAGAATGACCA
CAGAATGACCA -> AGAATGACCAT
AGAATGACCAT -> GAATGACCATT
GAATGACCATT -> AATGACCATTG
AATGACCATTG -> ATGACCATTGG
ATGACCATTGG -> TGACCATTGGC
TGACCATTGGC -> GACCATTGGCC
GACCATTGGCC -> ACCATTGGCCA
ACCATTGGCCA -> CCATTGGCCAA
CCATTGGCCAA -> CATTGGCCAAG
CATTGGCCAAG -> ATTGGCCAAGT
ATTGGCCAAGT -> TTGGCCAAGTT
TTGGCCAAGTT -> TGGCCAAGTTC
TGGCCAAGTTC -> GGCCAAGTTCA
GGCCAAGTTCA -> GCCAAGTTCAA
GCCAAGTTCAA -> CCAAGTTCAAG
CCAAGTTCAAG -> CAAGTTCAAGT
CAAGTTCAAGT -> AAGTTCAAGTA
AAGTTCAAGTA -> AGTTCAAGTAT
AGTTCAAGTAT -> GTTCAAGTATC
GTTCAAGTATC -> TTCAAGTATCC
TTCAAGTATCC -> TCAAGTATCCC
TCAAGTATCCC -> CAAGTATCCCT
CAAGTATCCCT -> AAGTATCCCTT
AAGTATCCCTT -> AGTATCCCTTG
AGTATCCCTTG -> GTATCCCTTGC
GTATCCCTTGC -> TATCCCTTGCC
TATCCCTTGCC -> ATCCCTTGCCG
ATCCCTTGCCG -> TCCCTTGCCGA
TCCCTTGCCGA -> CCCTTGCCGAT
CCCTTGCCGAT -> CCTTGCCGATG
CCTTGCCGATG -> CTTGCCGATGC
CTTGCCGATGC -> TTGCCGATGCG
TTGCCGATGCG -> TGCCGATGCGC
TGCCGATGCGC -> GCCGATGCGCC
GCCGATGCGCC -> CCGATGCGCCA
CCGATGCGCCA -> CGATGCGCCAC
CGATGCGCCAC -> GATGCGCCACA
GATGCGCCACA -> ATGCGCCACAA
ATGCGCCACAA -> TGCGCCACAAC
TGCGCCACAAC -> GCGCCACAACA
GCGCCACAACA -> CGCCACAACAC
CGCCACAACAC -> GCCACAACACT
GCCACAACACT -> CCACAACACTG
CCACAACACTG -> CACAACACTGC
CACAACACTGC -> ACAACACTGCA
ACAACACTGCA -> CAACACTGCAC
CAACACTGCAC -> AACACTGCACA
AACACTGCACA -> ACACTGCACAA
ACACTGCACAA -> CACTGCACAAG
CACTGCACAAG -> ACTGCACAAGT
ACTGCACAAGT -> CTGCACAAGTA
CTGCACAAGTA -> TGCACAAGTAG
TGCACAAGTAG -> GCACAAGTAGA
GCACAAGTAGA -> CACAAGTAGAA
CACAAGTAGAA -> ACAAGTAGAAA
ACAAGTAGAAA -> CAAGTAGAAAA
CAAGTAGAAAA -> AAGTAGAAAAT
AAGTAGAAAAT -> AGTAGAAAATC
AGTAGAAAATC -> GTAGAAAATCA
GTAGAAAATCA -> TAGAAAATCAG
TAGAAAATCAG -> AGAAAATCAGA
AGAAAATCAGA -> GAAAATCAGAT
GAAAATCAGAT -> AAAATCAGATG
AAAATCAGATG -> AAATCAGATGT
AAATCAGATGT -> AATCAGATGTA
AATCAGATGTA -> ATCAGATGTAA
ATCAGATGTAA -> TCAGATGTAAT
TCAGATGTAAT -> CAGATGTAATA
CAGATGTAATA -> AGATGTAATAT
AGATGTAATAT -> GATGTAATATA
GATGTAATATA -> ATGTAATATAA
ATGTAATATAA -> TGTAATATAAG
TGTAATATAAG -> GTAATATAAGA
GTAATATAAGA -> TAATATAAGAC
TAATATAAGAC -> AATATAAGACA
AATATAAGACA -> ATATAAGACAT
ATATAAGACAT -> TATAAGACATC
TATAAGACATC -> ATAAGACATCC
ATAAGACATCC -> TAAGACATCCA
TAAGACATCCA -> AAGACATCCAA
AAGACATCCAA -> AGACATCCAAA
AGACATCCAAA -> GACATCCAAAA
GACATCCAAAA -> ACATCCAAAAC
ACATCCAAAAC -> CATCCAAAACG
CATCCAAAACG -> ATCCAAAACGC
ATCCAAAACGC -> TCCAAAACGCG
TCCAAAACGCG -> CCAAAACGCGA
CCAAAACGCGA -> CAAAACGCGAT
CAAAACGCGAT -> AAAACGCGATA
AAAACGCGATA -> AAACGCGATAA
AAACGCGATAA -> AACGCGATAAA
AACGCGATAAA -> ACGCGATAAAT
ACGCGATAAAT -> CGCGATAAATA
CGCGATAAATA -> GCGATAAATAC
GCGATAAATAC -> CGATAAATACT
CGATAAATACT -> GATAAATACTA
GATAAATACTA -> ATAAATACTAC
ATAAATACTAC -> TAAATACTACT
TAAATACTACT -> AAATACTACTT
AAATACTACTT -> AATACTACTTT
AATACTACTTT -> ATACTACTTTG
ATACTACTTTG -> TACTACTTTGG
TACTACTTTGG -> ACTACTTTGGT
ACTACTTTGGT -> CTACTTTGGTT
CTACTTTGGTT -> TACTTTGGTTG
TACTTTGGTTG -> ACTTTGGTTGC
ACTTTGGTTGC -> CTTTGGTTGCC
CTTTGGTTGCC -> TTTGGTTGCCA
TTTGGTTGCCA -> TTGGTTGCCAT
TTGGTTGCCAT -> TGGTTGCCATT
TGGTTGCCATT -> GGTTGCCATTC
GGTTGCCATTC -> GTTGCCATTCC
GTTGCCATTCC -> TTGCCATTCCG
TTGCCATTCCG -> TGCCATTCCGT
TGCCATTCCGT -> GCCATTCCGTT
GCCATTCCGTT -> CCATTCCGTTG
CCATTCCGTTG -> CATTCCGTTGT
CATTCCGTTGT -> ATTCCGTTGTT
ATTCCGTTGTT -> TTCCGTTGTTG
TTCCGTTGTTG -> TCCGTTGTTGT
TCCGTTGTTGT -> CCGTTGTTGTT
CCGTTGTTGTT -> CGTTGTTGTTA
CGTTGTTGTTA -> GTTGTTGTTAC
GTTGTTGTTAC -> TTGTTGTTACG
TTGTTGTTACG -> TGTTGTTACGA
TGTTGTTACGA -> GTTGTTACGAT
GTTGTTACGAT -> TTGTTACGATC
TTGTTACGATC -> TGTTACGATCT
TGTTACGATCT -> GTTACGATCTC
GTTACGATCTC -> TTACGATCTCG
TTACGATCTCG -> TACGATCTCGG
TACGATCTCGG -> ACGATCTCGGC
ACGATCTCGGC -> CGATCTCGGCG
CGATCTCGGCG -> GATCTCGGCGG
GATCTCGGCGG -> ATCTCGGCGGG
ATCTCGGCGGG -> TCTCGGCGGGG
TCTCGGCGGGG -> CTCGGCGGGGA
CTCGGCGGGGA -> TCGGCGGGGAG
TCGGCGGGGAG -> CGGCGGGGAGA
CGGCGGGGAGA -> GGCGGGGAGAG
GGCGGGGAGAG -> GCGGGGAGAGA
GCGGGGAGAGA -> CGGGGAGAGAG
CGGGGAGAGAG -> GGGGAGAGAGT
GGGGAGAGAGT -> GGGAGAGAGTA
GGGAGAGAGTA -> GGAGAGAGTAC
GGAGAGAGTAC -> GAGAGAGTACG
GAGAGAGTACG -> AGAGAGTACGC
AGAGAGTACGC -> GAGAGTACGCG
GAGAGTACGCG -> AGAGTACGCGA
AGAGTACGCGA -> GAGTACGCGAA
GAGTACGCGAA -> AGTACGCGAAG
AGTACGCGAAG -> GTACGCGAAGC
GTACGCGAAGC -> TACGCGAAGCC
TACGCGAAGCC -> ACGCGAAGCCA
ACGCGAAGCCA -> CGCGAAGCCAG
CGCGAAGCCAG -> GCGAAGCCAGT
GCGAAGCCAGT -> CGAAGCCAGTA
CGAAGCCAGTA -> GAAGCCAGTAA
GAAGCCAGTAA -> AAGCCAGTAAG
AAGCCAGTAAG -> AGCCAGTAAGT
AGCCAGTAAGT -> GCCAGTAAGTA
GCCAGTAAGTA -> CCAGTAAGTAA
CCAGTAAGTAA -> CAGTAAGTAAG
CAGTAAGTAAG -> AGTAAGTAAGT
AGTAAGTAAGT -> GTAAGTAAGTC
GTAAGTAAGTC -> TAAGTAAGTCG
TAAGTAAGTCG -> AAGTAAGTCGC
AAGTAAGTCGC -> AGTAAGTCGCG
AGTAAGTCGCG -> GTAAGTCGCGG
GTAAGTCGCGG -> TAAGTCGCGGG
TAAGTCGCGGG -> AAGTCGCGGGT
AAGTCGCGGGT -> AGTCGCGGGTG
AGTCGCGGGTG -> GTCGCGGGTGT
GTCGCGGGTGT -> TCGCGGGTGTC
TCGCGGGTGTC -> CGCGGGTGTCT
CGCGGGTGTCT -> GCGGGTGTCTT
GCGGGTGTCTT -> CGGGTGTCTTA
CGGGTGTCTTA -> GGGTGTCTTAC
GGGTGTCTTAC -> GGTGTCTTACA
GGTGTCTTACA -> GTGTCTTACAC
GTGTCTTACAC -> TGTCTTACACT
TGTCTTACACT -> GTCTTACACTT
GTCTTACACTT -> TCTTACACTTA
TCTTACACTTA -> CTTACACTTAA
CTTACACTTAA -> TTACACTTAAA
TTACACTTAAA -> TACACTTAAAC
TACACTTAAAC -> ACACTTAAACT
ACACTTAAACT -> CACTTAAACTA
CACTTAAACTA -> ACTTAAACTAG
ACTTAAACTAG -> CTTAAACTAGG
CTTAAACTAGG -> TTAAACTAGGC
TTAAACTAGGC -> TAAACTAGGCT
TAAACTAGGCT -> AAACTAGGCTG
AAACTAGGCTG -> AACTAGGCTGG
AACTAGGCTGG -> ACTAGGCTGGC
ACTAGGCTGGC -> CTAGGCTGGCG
CTAGGCTGGCG -> TAGGCTGGCGT
TAGGCTGGCGT -> AGGCTGGCGTC
AGGCTGGCGTC -> GGCTGGCGTCA
GGCTGGCGTCA -> GCTGGCGTCAT
GCTGGCGTCAT -> CTGGCGTCATC
CTGGCGTCATC -> TGGCGTCATCT
TGGCGTCATCT -> GGCGTCATCTC
GGCGTCATCTC -> GCGTCATCTCA
GCGTCATCTCA -> CGTCATCTCAG
CGTCATCTCAG -> GTCATCTCAGG
GTCATCTCAGG -> TCATCTCAGGC
TCATCTCAGGC -> CATCTCAGGCT
CATCTCAGGCT -> ATCTCAGGCTC
ATCTCAGGCTC -> TCTCAGGCTCA
TCTCAGGCTCA -> CTCAGGCTCAC
CTCAGGCTCAC -> TCAGGCTCACA
TCAGGCTCACA -> CAGGCTCACAT
CAGGCTCACAT -> AGGCTCACATA
AGGCTCACATA -> GGCTCACATAC
GGCTCACATAC -> GCTCACATACC
GCTCACATACC -> CTCACATACCA
CTCACATACCA -> TCACATACCAC
TCACATACCAC -> CACATACCACC
CACATACCACC -> ACATACCACCA
ACATACCACCA -> CATACCACCAG
CATACCACCAG -> ATACCACCAGT
ATACCACCAGT -> TACCACCAGTA
TACCACCAGTA -> ACCACCAGTAT
ACCACCAGTAT -> CCACCAGTATA
CCACCAGTATA -> CACCAGTATAG
CACCAGTATAG -> ACCAGTATAGA
ACCAGTATAGA -> CCAGTATAGAC
CCAGTATAGAC -> CAGTATAGACT
CAGTATAGACT -> AGTATAGACTA
AGTATAGACTA -> GTATAGACTAC
GTATAGACTAC -> TATAGACTACA
TATAGACTACA -> ATAGACTACAG
ATAGACTACAG -> TAGACTACAGG
TAGACTACAGG -> AGACTACAGGC
AGACTACAGGC -> GACTACAGGCA
GACTACAGGCA -> ACTACAGGCAA
ACTACAGGCAA -> CTACAGGCAAG
CTACAGGCAAG -> TACAGGCAAGA
TACAGGCAAGA -> ACAGGCAAGAC
ACAGGCAAGAC -> CAGGCAAGACA
CAGGCAAGACA -> AGGCAAGACAA
AGGCAAGACAA -> GGCAAGACAAG
GGCAAGACAAG -> GCAAGACAAGC
GCAAGACAAGC -> CAAGACAAGCT
CAAGACAAGCT -> AAGACAAGCTC
AAGACAAGCTC -> AGACAAGCTCT
AGACAAGCTCT -> GACAAGCTCTT
GACAAGCTCTT -> ACAAGCTCTTA
ACAAGCTCTTA -> CAAGCTCTTAT
CAAGCTCTTAT -> AAGCTCTTATC
AAGCTCTTATC -> AGCTCTTATCT
AGCTCTTATCT -> GCTCTTATCTC
GCTCTTATCTC -> CTCTTATCTCT
CTCTTATCTCT -> TCTTATCTCTA
TCTTATCTCTA -> CTTATCTCTAT
CTTATCTCTAT -> TTATCTCTATT
TTATCTCTATT -> TATCTCTATTC
TATCTCTATTC -> ATCTCTATTCG
ATCTCTATTCG -> TCTCTATTCGA
TCTCTATTCGA -> CTCTATTCGAG
CTCTATTCGAG -> TCTATTCGAGT
TCTATTCGAGT -> CTATTCGAGTC
CTATTCGAGTC -> TATTCGAGTCA
TATTCGAGTCA -> ATTCGAGTCAC
ATTCGAGTCAC -> TTCGAGTCACA
TTCGAGTCACA -> TCGAGTCACAC
TCGAGTCACAC -> CGAGTCACACG
CGAGTCACACG -> GAGTCACACGG
GAGTCACACGG -> AGTCACACGGA
AGTCACACGGA -> GTCACACGGAA
GTCACACGGAA -> TCACACGGAAA
TCACACGGAAA -> CACACGGAAAC
CACACGGAAAC -> ACACGGAAACG
ACACGGAAACG -> CACGGAAACGT
CACGGAAACGT -> ACGGAAACGTA
ACGGAAACGTA -> CGGAAACGTAC
CGGAAACGTAC -> GGAAACGTACG
GGAAACGTACG -> GAAACGTACGA
GAAACGTACGA -> AAACGTACGAA
AAACGTACGAA -> AACGTACGAAA
AACGTACGAAA -> ACGTACGAAAA
ACGTACGAAAA -> CGTACGAAAAA
CGTACGAAAAA -> GTACGAAAAAT
GTACGAAAAAT -> TACGAAAAATA
TACGAAAAATA -> ACGAAAAATAT
ACGAAAAATAT -> CGAAAAATATG
CGAAAAATATG -> GAAAAATATGC
GAAAAATATGC -> AAAAATATGCC
AAAAATATGCC -> AAAATATGCCT
AAAATATGCCT -> AAATATGCCTG
AAATATGCCTG -> AATATGCCTGT
AATATGCCTGT -> ATATGCCTGTA
ATATGCCTGTA -> TATGCCTGTAT
TATGCCTGTAT -> ATGCCTGTATC
ATGCCTGTATC -> TGCCTGTATCG
TGCCTGTATCG -> GCCTGTATCGA
GCCTGTATCGA -> CCTGTATCGAT
CCTGTATCGAT -> CTGTATCGATG
CTGTATCGATG -> TGTATCGATGG
TGTATCGATGG -> GTATCGATGGA
GTATCGATGGA -> TATCGATGGAC
TATCGATGGAC -> ATCGATGGACG
ATCGATGGACG -> TCGATGGACGC
TCGATGGACGC -> CGATGGACGCA
CGATGGACGCA -> GATGGACGCAG
GATGGACGCAG -> ATGGACGCAGG
ATGGACGCAGG -> TGGACGCAGGC
TGGACGCAGGC -> GGACGCAGGCA
GGACGCAGGCA -> GACGCAGGCAG
GACGCAGGCAG -> ACGCAGGCAGG
ACGCAGGCAGG -> CGCAGGCAGGT
CGCAGGCAGGT -> GCAGGCAGGTT
GCAGGCAGGTT -> CAGGCAGGTTA
CAGGCAGGTTA -> AGGCAGGTTAT
AGGCAGGTTAT -> GGCAGGTTATT
GGCAGGTTATT -> GCAGGTTATTA
GCAGGTTATTA -> CAGGTTATTAA
CAGGTTATTAA -> AGGTTATTAAA
AGGTTATTAAA -> GGTTATTAAAA
GGTTATTAAAA -> GTTATTAAAAC
GTTATTAAAAC -> TTATTAAAACC
TTATTAAAACC -> TATTAAAACCC
TATTAAAACCC -> ATTAAAACCCC
ATTAAAACCCC -> TTAAAACCCCG
TTAAAACCCCG -> TAAAACCCCGT
TAAAACCCCGT -> AAAACCCCGTA
AAAACCCCGTA -> AAACCCCGTAG
AAACCCCGTAG -> AACCCCGTAGA
AACCCCGTAGA -> ACCCCGTAGAG
ACCCCGTAGAG -> CCCCGTAGAGC
CCCCGTAGAGC -> CCCGTAGAGCC
CCCGTAGAGCC -> CCGTAGAGCCC
CCGTAGAGCCC -> CGTAGAGCCCA
CGTAGAGCCCA -> GTAGAGCCCAA
GTAGAGCCCAA -> TAGAGCCCAAA
TAGAGCCCAAA -> AGAGCCCAAAT
AGAGCCCAAAT -> GAGCCCAAATG
GAGCCCAAATG -> AGCCCAAATGC
AGCCCAAATGC -> GCCCAAATGCC
GCCCAAATGCC -> CCCAAATGCCC
CCCAAATGCCC -> CCAAATGCCCC
CCAAATGCCCC -> CAAATGCCCCG
CAAATGCCCCG -> AAATGCCCCGT
AAATGCCCCGT -> AATGCCCCGTG
AATGCCCCGTG -> ATGCCCCGTGG
ATGCCCCGTGG -> TGCCCCGTGGC
TGCCCCGTGGC -> GCCCCGTGGCA
GCCCCGTGGCA -> CCCCGTGGCAG
CCCCGTGGCAG -> CCCGTGGCAGC
CCCGTGGCAGC -> CCGTGGCAGCG
CCGTGGCAGCG -> CGTGGCAGCGA
CGTGGCAGCGA -> GTGGCAGCGAA
GTGGCAGCGAA -> TGGCAGCGAAG
TGGCAGCGAAG -> GGCAGCGAAGT
GGCAGCGAAGT -> GCAGCGAAGTG
GCAGCGAAGTG -> CAGCGAAGTGC
CAGCGAAGTGC -> AGCGAAGTGCA
AGCGAAGTGCA -> GCGAAGTGCAC
GCGAAGTGCAC -> CGAAGTGCACG
CGAAGTGCACG -> GAAGTGCACGC
GAAGTGCACGC -> AAGTGCACGCG
AAGTGCACGCG -> AGTGCACGCGC
AGTGCACGCGC -> GTGCACGCGCT
GTGCACGCGCT -> TGCACGCGCTA
TGCACGCGCTA -> GCACGCGCTAC
GCACGCGCTAC -> CACGCGCTACC
CACGCGCTACC -> ACGCGCTACCT
ACGCGCTACCT -> CGCGCTACCTC
CGCGCTACCTC -> GCGCTACCTCG
GCGCTACCTCG -> CGCTACCTCGT
CGCTACCTCGT -> GCTACCTCGTA
GCTACCTCGTA -> CTACCTCGTAC
CTACCTCGTAC -> TACCTCGTACT
TACCTCGTACT -> ACCTCGTACTT
ACCTCGTACTT -> CCTCGTACTTA
CCTCGTACTTA -> CTCGTACTTAT
CTCGTACTTAT -> TCGTACTTATT
TCGTACTTATT -> CGTACTTATTG
CGTACTTATTG -> GTACTTATTGC
GTACTTATTGC -> TACTTATTGCC
TACTTATTGCC -> ACTTATTGCCG
ACTTATTGCCG -> CTTATTGCCGA
CTTATTGCCGA -> TTATTGCCGAC
TTATTGCCGAC -> TATTGCCGACC
TATTGCCGACC -> ATTGCCGACCA
ATTGCCGACCA -> TTGCCGACCAC
TTGCCGACCAC -> TGCCGACCACT
TGCCGACCACT -> GCCGACCACTT
GCCGACCACTT -> CCGACCACTTG
CCGACCACTTG -> CGACCACTTGG
CGACCACTTGG -> GACCACTTGGG
GACCACTTGGG -> ACCACTTGGGC
ACCACTTGGGC -> CCACTTGGGCG
CCACTTGGGCG -> CACTTGGGCGT
CACTTGGGCGT -> ACTTGGGCGTT
ACTTGGGCGTT -> CTTGGGCGTTT
CTTGGGCGTTT -> TTGGGCGTTTC
TTGGGCGTTTC -> TGGGCGTTTCC
TGGGCGTTTCC -> GGGCGTTTCCG
GGGCGTTTCCG -> GGCGTTTCCGG
GGCGTTTCCGG -> GCGTTTCCGGA
GCGTTTCCGGA -> CGTTTCCGGAA
CGTTTCCGGAA -> GTTTCCGGAAT
GTTTCCGGAAT -> TTTCCGGAATT
TTTCCGGAATT -> TTCCGGAATTA
TTCCGGAATTA -> TCCGGAATTAG
TCCGGAATTAG -> CCGGAATTAGC
CCGGAATTAGC -> CGGAATTAGCG
CGGAATTAGCG -> GGAATTAGCGT
GGAATTAGCGT -> GAATTAGCGTC
GAATTAGCGTC -> AATTAGCGTCT
AATTAGCGTCT -> ATTAGCGTCTG
ATTAGCGTCTG -> TTAGCGTCTGA
TTAGCGTCTGA -> TAGCGTCTGAG
TAGCGTCTGAG -> AGCGTCTGAGT
AGCGTCTGAGT -> GCGTCTGAGTC
GCGTCTGAGTC -> CGTCTGAGTCC
CGTCTGAGTCC -> GTCTGAGTCCA
GTCTGAGTCCA -> TCTGAGTCCAC
TCTGAGTCCAC -> CTGAGTCCACC
CTGAGTCCACC -> TGAGTCCACCA
TGAGTCCACCA -> GAGTCCACCAA
GAGTCCACCAA -> AGTCCACCAAG
AGTCCACCAAG -> GTCCACCAAGG
GTCCACCAAGG -> TCCACCAAGGG
TCCACCAAGGG -> CCACCAAGGGA
CCACCAAGGGA -> CACCAAGGGAT
CACCAAGGGAT -> ACCAAGGGATC
ACCAAGGGATC -> CCAAGGGATCA
CCAAGGGATCA -> CAAGGGATCAT
CAAGGGATCAT -> AAGGGATCATG
AAGGGATCATG -> AGGGATCATGG
AGGGATCATGG -> GGGATCATGGA
GGGATCATGGA -> GGATCATGGAA
GGATCATGGAA -> GATCATGGAAA
GATCATGGAAA -> ATCATGGAAAC
ATCATGGAAAC -> TCATGGAAACT
TCATGGAAACT -> CATGGAAACTA
CATGGAAACTA -> ATGGAAACTAG
ATGGAAACTAG -> TGGAAACTAGG
TGGAAACTAGG -> GGAAACTAGGC
GGAAACTAGGC -> GAAACTAGGCA
GAAACTAGGCA -> AAACTAGGCAT
AAACTAGGCAT -> AACTAGGCATC
AACTAGGCATC -> ACTAGGCATCC
ACTAGGCATCC -> CTAGGCATCCA
CTAGGCATCCA -> TAGGCATCCAT
TAGGCATCCAT -> AGGCATCCATG
AGGCATCCATG -> GGCATCCATGA
GGCATCCATGA -> GCATCCATGAG
GCATCCATGAG -> CATCCATGAGT
CATCCATGAGT -> ATCCATGAGTG
ATCCATGAGTG -> TCCATGAGTGG
TCCATGAGTGG -> CCATGAGTGGG
CCATGAGTGGG -> CATGAGTGGGT
CATGAGTGGGT -> ATGAGTGGGTA
ATGAGTGGGTA -> TGAGTGGGTAT
TGAGTGGGTAT -> GAGTGGGTATG
GAGTGGGTATG -> AGTGGGTATGT
AGTGGGTATGT -> GTGGGTATGTC
GTGGGTATGTC -> TGGGTATGTCA
TGGGTATGTCA -> GGGTATGTCAA
GGGTATGTCAA -> GGTATGTCAAA
GGTATGTCAAA -> GTATGTCAAAG
GTATGTCAAAG -> TATGTCAAAGA
TATGTCAAAGA -> ATGTCAAAGAG
ATGTCAAAGAG -> TGTCAAAGAGG
TGTCAAAGAGG -> GTCAAAGAGGC
GTCAAAGAGGC -> TCAAAGAGGCA
TCAAAGAGGCA -> CAAAGAGGCAT
CAAAGAGGCAT -> AAAGAGGCATA
AAAGAGGCATA -> AAGAGGCATAT
AAGAGGCATAT -> AGAGGCATATG
AGAGGCATATG -> GAGGCATATGC
GAGGCATATGC -> AGGCATATGCC
AGGCATATGCC -> GGCATATGCCA
GGCATATGCCA -> GCATATGCCAA
GCATATGCCAA -> CATATGCCAAC
CATATGCCAAC -> ATATGCCAACT
ATATGCCAACT -> TATGCCAACTA
TATGCCAACTA -> ATGCCAACTAC
ATGCCAACTAC -> TGCCAACTACA
TGCCAACTACA -> GCCAACTACAG
GCCAACTACAG -> CCAACTACAGT
CCAACTACAGT -> CAACTACAGTC
CAACTACAGTC -> AACTACAGTCC
AACTACAGTCC -> ACTACAGTCCA
ACTACAGTCCA -> CTACAGTCCAC
CTACAGTCCAC -> TACAGTCCACT
TACAGTCCACT -> ACAGTCCACTT
ACAGTCCACTT -> CAGTCCACTTG
CAGTCCACTTG -> AGTCCACTTGA
AGTCCACTTGA -> GTCCACTTGAA
GTCCACTTGAA -> TCCACTTGAAT
TCCACTTGAAT -> CCACTTGAATC
CCACTTGAATC -> CACTTGAATCT
CACTTGAATCT -> ACTTGAATCTG
ACTTGAATCTG -> CTTGAATCTGT
CTTGAATCTGT -> TTGAATCTGTT
TTGAATCTGTT -> TGAATCTGTTG
TGAATCTGTTG -> GAATCTGTTGC
GAATCTGTTGC -> AATCTGTTGCA
AATCTGTTGCA -> ATCTGTTGCAG
ATCTGTTGCAG -> TCTGTTGCAGC
TCTGTTGCAGC -> CTGTTGCAGCC
CTGTTGCAGCC -> TGTTGCAGCCG
TGTTGCAGCCG -> GTTGCAGCCGA
GTTGCAGCCGA -> TTGCAGCCGAA
TTGCAGCCGAA -> TGCAGCCGAAC
TGCAGCCGAAC -> GCAGCCGAACC
GCAGCCGAACC -> CAGCCGAACCA
CAGCCGAACCA -> AGCCGAACCAT
AGCCGAACCAT -> GCCGAACCATA
GCCGAACCATA -> CCGAACCATAA
CCGAACCATAA -> CGAACCATAAT
CGAACCATAAT -> GAACCATAATG
GAACCATAATG -> AACCATAATGA
AACCATAATGA -> ACCATAATGAT
ACCATAATGAT -> CCATAATGATG
CCATAATGATG -> CATAATGATGA
CATAATGATGA -> ATAATGATGAG
ATAATGATGAG -> TAATGATGAGA
TAATGATGAGA -> AATGATGAGAC
AATGATGAGAC -> ATGATGAGACC
ATGATGAGACC -> TGATGAGACCG
TGATGAGACCG -> GATGAGACCGT
GATGAGACCGT -> ATGAGACCGTA
ATGAGACCGTA -> TGAGACCGTAA
TGAGACCGTAA -> GAGACCGTAAG
GAGACCGTAAG -> AGACCGTAAGT
AGACCGTAAGT -> GACCGTAAGTG
GACCGTAAGTG -> ACCGTAAGTGA
ACCGTAAGTGA -> CCGTAAGTGAC
CCGTAAGTGAC -> CGTAAGTGACC
CGTAAGTGACC -> GTAAGTGACCG
GTAAGTGACCG -> TAAGTGACCGA
TAAGTGACCGA -> AAGTGACCGAC
AAGTGACCGAC -> AGTGACCGACA
AGTGACCGACA -> GTGACCGACAG
GTGACCGACAG -> TGACCGACAGA
TGACCGACAGA -> GACCGACAGAA
GACCGACAGAA -> ACCGACAGAAG
ACCGACAGAAG -> CCGACAGAAGA
CCGACAGAAGA -> CGACAGAAGAT
CGACAGAAGAT -> GACAGAAGATT
GACAGAAGATT -> ACAGAAGATTA
ACAGAAGATTA -> CAGAAGATTAA
CAGAAGATTAA -> AGAAGATTAAA
AGAAGATTAAA -> GAAGATTAAAA
GAAGATTAAAA -> AAGATTAAAAC
AAGATTAAAAC -> AGATTAAAACG
AGATTAAAACG -> GATTAAAACGC
GATTAAAACGC -> ATTAAAACGCA
ATTAAAACGCA -> TTAAAACGCAT
TTAAAACGCAT -> TAAAACGCATA
TAAAACGCATA -> AAAACGCATAA
AAAACGCATAA -> AAACGCATAAC
AAACGCATAAC -> AACGCATAACT
AACGCATAACT -> ACGCATAACTA
ACGCATAACTA -> CGCATAACTAT
CGCATAACTAT -> GCATAACTATG
GCATAACTATG -> CATAACTATGT
CATAACTATGT -> ATAACTATGTC
ATAACTATGTC -> TAACTATGTCT
TAACTATGTCT -> AACTATGTCTT
AACTATGTCTT -> ACTATGTCTTG
ACTATGTCTTG -> CTATGTCTTGA
CTATGTCTTGA -> TATGTCTTGAT
TATGTCTTGAT -> ATGTCTTGATG
ATGTCTTGATG -> TGTCTTGATGT
TGTCTTGATGT -> GTCTTGATGTT
GTCTTGATGTT -> TCTTGATGTTC
TCTTGATGTTC -> CTTGATGTTCG
CTTGATGTTCG -> TTGATGTTCGA
TTGATGTTCGA -> TGATGTTCGAG
TGATGTTCGAG -> GATGTTCGAGG
GATGTTCGAGG -> ATGTTCGAGGA
ATGTTCGAGGA -> TGTTCGAGGAA
TGTTCGAGGAA -> GTTCGAGGAAG
GTTCGAGGAAG -> TTCGAGGAAGA
TTCGAGGAAGA -> TCGAGGAAGAC
TCGAGGAAGAC -> CGAGGAAGACG
CGAGGAAGACG -> GAGGAAGACGT
GAGGAAGACGT -> AGGAAGACGTT
AGGAAGACGTT -> GGAAGACGTTT
GGAAGACGTTT -> GAAGACGTTTA
GAAGACGTTTA -> AAGACGTTTAG
AAGACGTTTAG -> AGACGTTTAGA
AGACGTTTAGA -> GACGTTTAGAG
GACGTTTAGAG -> ACGTTTAGAGC
ACGTTTAGAGC -> CGTTTAGAGCA
CGTTTAGAGCA -> GTTTAGAGCAT
GTTTAGAGCAT -> TTTAGAGCATG
TTTAGAGCATG -> TTAGAGCATGC
TTAGAGCATGC -> TAGAGCATGCA
TAGAGCATGCA -> AGAGCATGCAA
AGAGCATGCAA -> GAGCATGCAAA
GAGCATGCAAA -> AGCATGCAAAT
AGCATGCAAAT -> GCATGCAAATG
GCATGCAAATG -> CATGCAAATGT
CATGCAAATGT -> ATGCAAATGTG
ATGCAAATGTG -> TGCAAATGTGC
TGCAAATGTGC -> GCAAATGTGCT
GCAAATGTGCT -> CAAATGTGCTT
CAAATGTGCTT -> AAATGTGCTTG
AAATGTGCTTG -> AATGTGCTTGC
AATGTGCTTGC -> ATGTGCTTGCA
ATGTGCTTGCA -> TGTGCTTGCAG
TGTGCTTGCAG -> GTGCTTGCAGT
GTGCTTGCAGT -> TGCTTGCAGTG
TGCTTGCAGTG -> GCTTGCAGTGT
GCTTGCAGTGT -> CTTGCAGTGTC
CTTGCAGTGTC -> TTGCAGTGTCC
TTGCAGTGTCC -> TGCAGTGTCCC
TGCAGTGTCCC -> GCAGTGTCCCT
CAGTGTCCCTA -> AGTGTCCCTAC
AGTGTCCCTAC -> GTGTCCCTACA
GTGTCCCTACA -> TGTCCCTACAG
TGTCCCTACAG -> GTCCCTACAGG
GTCCCTACAGG -> TCCCTACAGGC
TCCCTACAGGC -> CCCTACAGGCA
CCCTACAGGCA -> CCTACAGGCAG
CCTACAGGCAG -> CTACAGGCAGT
CTACAGGCAGT -> TACAGGCAGTA
TACAGGCAGTA -> ACAGGCAGTAC
ACAGGCAGTAC -> CAGGCAGTACC
CAGGCAGTACC -> AGGCAGTACCC
AGGCAGTACCC -> GGCAGTACCCA
GGCAGTACCCA -> GCAGTACCCAC
GCAGTACCCAC -> CAGTACCCACC
CAGTACCCACC -> AGTACCCACCA
AGTACCCACCA -> GTACCCACCAT
GTACCCACCAT -> TACCCACCATC
TACCCACCATC -> ACCCACCATCC
ACCCACCATCC -> CCCACCATCCT
CCCACCATCCT -> CCACCATCCTT
CCACCATCCTT -> CACCATCCTTC
CACCATCCTTC -> ACCATCCTTCT
ACCATCCTTCT -> CCATCCTTCTT
CCATCCTTCTT -> CATCCTTCTTT
CATCCTTCTTT -> ATCCTTCTTTC
ATCCTTCTTTC -> TCCTTCTTTCC
TCCTTCTTTCC -> CCTTCTTTCCT
CCTTCTTTCCT -> CTTCTTTCCTG
CTTCTTTCCTG -> TTCTTTCCTGT
TTCTTTCCTGT -> TCTTTCCTGTA
TCTTTCCTGTA -> CTTTCCTGTAA
CTTTCCTGTAA -> TTTCCTGTAAC
TTTCCTGTAAC -> TTCCTGTAACG
TTCCTGTAACG -> TCCTGTAACGC
TCCTGTAACGC -> CCTGTAACGCC
CCTGTAACGCC -> CTGTAACGCCA
CTGTAACGCCA -> TGTAACGCCAC
TGTAACGCCAC -> GTAACGCCACA
GTAACGCCACA -> TAACGCCACAG
TAACGCCACAG -> AACGCCACAGT
AACGCCACAGT -> ACGCCACAGTA
ACGCCACAGTA -> CGCCACAGTAA
CGCCACAGTAA -> GCCACAGTAAT
GCCACAGTAAT -> CCACAGTAATG
CCACAGTAATG -> CACAGTAATGT
CACAGTAATGT -> ACAGTAATGTC
ACAGTAATGTC -> CAGTAATGTCT
CAGTAATGTCT -> AGTAATGTCTA
AGTAATGTCTA -> GTAATGTCTAA
GTAATGTCTAA -> TAATGTCTAAT
TAATGTCTAAT -> AATGTCTAATT
AATGTCTAATT -> ATGTCTAATTA
ATGTCTAATTA -> TGTCTAATTAA
TGTCTAATTAA -> GTCTAATTAAT
GTCTAATTAAT -> TCTAATTAATT
TCTAATTAATT -> CTAATTAATTG
CTAATTAATTG -> TAATTAATTGA
TAATTAATTGA -> AATTAATTGAT
AATTAATTGAT -> ATTAATTGATC
ATTAATTGATC -> TTAATTGATCA
TTAATTGATCA -> TAATTGATCAT
TAATTGATCAT -> AATTGATCATA
AATTGATCATA -> ATTGATCATAC
ATTGATCATAC -> TTGATCATACG
TTGATCATACG -> TGATCATACGT
TGATCATACGT -> GATCATACGTG
GATCATACGTG -> ATCATACGTGC
ATCATACGTGC -> TCATACGTGCA
TCATACGTGCA -> CATACGTGCAA
CATACGTGCAA -> ATACGTGCAAG
ATACGTGCAAG -> TACGTGCAAGG
TACGTGCAAGG -> ACGTGCAAGGC
ACGTGCAAGGC -> CGTGCAAGGCT
CGTGCAAGGCT -> GTGCAAGGCTA
GTGCAAGGCTA -> TGCAAGGCTAG
TGCAAGGCTAG -> GCAAGGCTAGC
GCAAGGCTAGC -> CAAGGCTAGCA
CAAGGCTAGCA -> AAGGCTAGCAG
AAGGCTAGCAG -> AGGCTAGCAGT
AGGCTAGCAGT -> GGCTAGCAGTG
GGCTAGCAGTG -> GCTAGCAGTGG
GCTAGCAGTGG -> CTAGCAGTGGT
CTAGCAGTGGT -> TAGCAGTGGTG
TAGCAGTGGTG -> AGCAGTGGTGG
AGCAGTGGTGG -> GCAGTGGTGGC
GCAGTGGTGGC -> CAGTGGTGGCC
CAGTGGTGGCC -> AGTGGTGGCCG
AGTGGTGGCCG -> GTGGTGGCCGG
GTGGTGGCCGG -> TGGTGGCCGGG
TGGTGGCCGGG -> GGTGGCCGGGG
GGTGGCCGGGG -> GTGGCCGGGGA
GTGGCCGGGGA -> TGGCCGGGGAG
TGGCCGGGGAG -> GGCCGGGGAGA
GGCCGGGGAGA -> GCCGGGGAGAA
GCCGGGGAGAA -> CCGGGGAGAAT
CCGGGGAGAAT -> CGGGGAGAATG
CGGGGAGAATG -> GGGGAGAATGG
GGGGAGAATGG -> GGGAGAATGGT
GGGAGAATGGT -> GGAGAATGGTA
GGAGAATGGTA -> GAGAATGGTAC
GAGAATGGTAC -> AGAATGGTACC
AGAATGGTACC -> GAATGGTACCT
GAATGGTACCT -> AATGGTACCTC
AATGGTACCTC -> ATGGTACCTCC
ATGGTACCTCC -> TGGTACCTCCA
TGGTACCTCCA -> GGTACCTCCAC
GGTACCTCCAC -> GTACCTCCACT
GTACCTCCACT -> TACCTCCACTC
TACCTCCACTC -> ACCTCCACTCA
ACCTCCACTCA -> CCTCCACTCAA, CCTCCACTCAC
CCTCCACTCAA -> CTCCACTCAAC
CTCCACTCAAC -> TCCACTCAACG
TCCACTCAACG -> CCACTCAACGA
CCACTCAACGA -> CACTCAACGAG
CACTCAACGAG -> ACTCAACGAGT
ACTCAACGAGT -> CTCAACGAGTG
CTCAACGAGTG -> TCAACGAGTGT
TCAACGAGTGT -> CAACGAGTGTG
CAACGAGTGTG -> AACGAGTGTGG
AACGAGTGTGG -> ACGAGTGTGGC
ACGAGTGTGGC -> CGAGTGTGGCC
CGAGTGTGGCC -> GAGTGTGGCCT
GAGTGTGGCCT -> AGTGTGGCCTC
AGTGTGGCCTC -> GTGTGGCCTCA
GTGTGGCCTCA -> TGTGGCCTCAC
TGTGGCCTCAC -> GTGGCCTCACG
GTGGCCTCACG -> TGGCCTCACGC
TGGCCTCACGC -> GGCCTCACGCG
GGCCTCACGCG -> GCCTCACGCGT
GCCTCACGCGT -> CCTCACGCGTC
CCTCACGCGTC -> CTCACGCGTCA
CTCACGCGTCA -> TCACGCGTCAT
TCACGCGTCAT -> CACGCGTCATG
CACGCGTCATG -> ACGCGTCATGG
ACGCGTCATGG -> CGCGTCATGGA
CGCGTCATGGA -> GCGTCATGGAT
GCGTCATGGAT -> CGTCATGGATC
CGTCATGGATC -> GTCATGGATCA
GTCATGGATCA -> TCATGGATCAT
TCATGGATCAT -> CATGGATCATA
CATGGATCATA -> ATGGATCATAC
ATGGATCATAC -> TGGATCATACA
TGGATCATACA -> GGATCATACAC
GGATCATACAC -> GATCATACACT
GATCATACACT -> ATCATACACTA
ATCATACACTA -> TCATACACTAG
TCATACACTAG -> CATACACTAGT
CATACACTAGT -> ATACACTAGTA
ATACACTAGTA -> TACACTAGTAG
TACACTAGTAG -> ACACTAGTAGT
ACACTAGTAGT -> CACTAGTAGTC
CACTAGTAGTC -> ACTAGTAGTCG
ACTAGTAGTCG -> CTAGTAGTCGC
CTAGTAGTCGC -> TAGTAGTCGCG
TAGTAGTCGCG -> AGTAGTCGCGC
AGTAGTCGCGC -> GTAGTCGCGCT
GTAGTCGCGCT -> TAGTCGCGCTT
TAGTCGCGCTT -> AGTCGCGCTTG
AGTCGCGCTTG -> GTCGCGCTTGC
GTCGCGCTTGC -> TCGCGCTTGCT
TCGCGCTTGCT -> CGCGCTTGCTC
CGCGCTTGCTC -> GCGCTTGCTCA
GCGCTTGCTCA -> CGCTTGCTCAG
CGCTTGCTCAG -> GCTTGCTCAGG
GCTTGCTCAGG -> CTTGCTCAGGT
CTTGCTCAGGT -> TTGCTCAGGTC
TTGCTCAGGTC -> TGCTCAGGTCG
TGCTCAGGTCG -> GCTCAGGTCGC
GCTCAGGTCGC -> CTCAGGTCGCG
CTCAGGTCGCG -> TCAGGTCGCGG
TCAGGTCGCGG -> CAGGTCGCGGG
CAGGTCGCGGG -> AGGTCGCGGGG
AGGTCGCGGGG -> GGTCGCGGGGC
GGTCGCGGGGC -> GTCGCGGGGCC
GTCGCGGGGCC -> TCGCGGGGCCG
TCGCGGGGCCG -> CGCGGGGCCGT
CGCGGGGCCGT -> GCGGGGCCGTT
GCGGGGCCGTT -> CGGGGCCGTTA
CGGGGCCGTTA -> GGGGCCGTTAC
GGGGCCGTTAC -> GGGCCGTTACT
GGGCCGTTACT -> GGCCGTTACTC
GGCCGTTACTC -> GCCGTTACTCG
GCCGTTACTCG -> CCGTTACTCGG
CCGTTACTCGG -> CGTTACTCGGT
CGTTACTCGGT -> GTTACTCGGTT
GTTACTCGGTT -> TTACTCGGTTC
TTACTCGGTTC -> TACTCGGTTCC
TACTCGGTTCC -> ACTCGGTTCCA
ACTCGGTTCCA -> CTCGGTTCCAG
CTCGGTTCCAG -> TCGGTTCCAGA
TCGGTTCCAGA -> CGGTTCCAGAT
CGGTTCCAGAT -> GGTTCCAGATA
GGTTCCAGATA -> GTTCCAGATAG
GTTCCAGATAG -> TTCCAGATAGA
TTCCAGATAGA -> TCCAGATAGAT
TCCAGATAGAT -> CCAGATAGATG
CCAGATAGATG -> CAGATAGATGG
CAGATAGATGG -> AGATAGATGGC
AGATAGATGGC -> GATAGATGGCA
GATAGATGGCA -> ATAGATGGCAC
ATAGATGGCAC -> TAGATGGCACC
TAGATGGCACC -> AGATGGCACCT
AGATGGCACCT -> GATGGCACCTC
GATGGCACCTC -> ATGGCACCTCC
ATGGCACCTCC -> TGGCACCTCCG
TGGCACCTCCG -> GGCACCTCCGT
GGCACCTCCGT -> GCACCTCCGTA
GCACCTCCGTA -> CACCTCCGTAG
CACCTCCGTAG -> ACCTCCGTAGT
ACCTCCGTAGT -> CCTCCGTAGTG
CCTCCGTAGTG -> CTCCGTAGTGG
CTCCGTAGTGG -> TCCGTAGTGGT
TCCGTAGTGGT -> CCGTAGTGGTT
CCGTAGTGGTT -> CGTAGTGGTTT
CGTAGTGGTTT -> GTAGTGGTTTC
GTAGTGGTTTC -> TAGTGGTTTCA
TAGTGGTTTCA -> AGTGGTTTCAT
AGTGGTTTCAT -> GTGGTTTCATG
GTGGTTTCATG -> TGGTTTCATGA
TGGTTTCATGA -> GGTTTCATGAG
GGTTTCATGAG -> GTTTCATGAGT
GTTTCATGAGT -> TTTCATGAGTT
TTTCATGAGTT -> TTCATGAGTTC
TTCATGAGTTC -> TCATGAGTTCG
TCATGAGTTCG -> CATGAGTTCGT
CATGAGTTCGT -> ATGAGTTCGTC
ATGAGTTCGTC -> TGAGTTCGTCA
TGAGTTCGTCA -> GAGTTCGTCAG
GAGTTCGTCAG -> AGTTCGTCAGT
AGTTCGTCAGT -> GTTCGTCAGTA
GTTCGTCAGTA -> TTCGTCAGTAT
TTCGTCAGTAT -> TCGTCAGTATT
TCGTCAGTATT -> CGTCAGTATTG
CGTCAGTATTG -> GTCAGTATTGT
GTCAGTATTGT -> TCAGTATTGTT
TCAGTATTGTT -> CAGTATTGTTT
CAGTATTGTTT -> AGTATTGTTTT
AGTATTGTTTT -> GTATTGTTTTG
GTATTGTTTTG -> TATTGTTTTGG
TATTGTTTTGG -> ATTGTTTTGGA
ATTGTTTTGGA -> TTGTTTTGGAA
TTGTTTTGGAA -> TGTTTTGGAAC
TGTTTTGGAAC -> GTTTTGGAACA
GTTTTGGAACA -> TTTTGGAACAT
TTTTGGAACAT -> TTTGGAACATA
TTTGGAACATA -> TTGGAACATAC
TTGGAACATAC -> TGGAACATACC
TGGAACATACC -> GGAACATACCT
GGAACATACCT -> GAACATACCTA
GAACATACCTA -> AACATACCTAT
AACATACCTAT -> ACATACCTATC
ACATACCTATC -> CATACCTATCA
CATACCTATCA -> ATACCTATCAG
ATACCTATCAG -> TACCTATCAGC
TACCTATCAGC -> ACCTATCAGCA
ACCTATCAGCA -> CCTATCAGCAG
CCTATCAGCAG -> CTATCAGCAGT
CTATCAGCAGT -> TATCAGCAGTG
TATCAGCAGTG -> ATCAGCAGTGC
ATCAGCAGTGC -> TCAGCAGTGCG
TCAGCAGTGCG -> CAGCAGTGCGA
CAGCAGTGCGA -> AGCAGTGCGAC
AGCAGTGCGAC -> GCAGTGCGACC
GCAGTGCGACC -> CAGTGCGACCA
CAGTGCGACCA -> AGTGCGACCAG
AGTGCGACCAG -> GTGCGACCAGA
GTGCGACCAGA -> TGCGACCAGAT
TGCGACCAGAT -> GCGACCAGATA
GCGACCAGATA -> CGACCAGATAC
CGACCAGATAC -> GACCAGATACG
GACCAGATACG -> ACCAGATACGA
ACCAGATACGA -> CCAGATACGAT
CCAGATACGAT -> CAGATACGATT
CAGATACGATT -> AGATACGATTC
AGATACGATTC -> GATACGATTCA
GATACGATTCA -> ATACGATTCAG
ATACGATTCAG -> TACGATTCAGG
TACGATTCAGG -> ACGATTCAGGT
ACGATTCAGGT -> CGATTCAGGTG
CGATTCAGGTG -> GATTCAGGTGT
GATTCAGGTGT -> ATTCAGGTGTG
ATTCAGGTGTG -> TTCAGGTGTGC
TTCAGGTGTGC -> TCAGGTGTGCG
TCAGGTGTGCG -> CAGGTGTGCGT
CAGGTGTGCGT -> AGGTGTGCGTT
AGGTGTGCGTT -> GGTGTGCGTTG
GGTGTGCGTTG -> GTGTGCGTTGG
GTGTGCGTTGG -> TGTGCGTTGGG
TGTGCGTTGGG -> GTGCGTTGGGA
GTGCGTTGGGA -> TGCGTTGGGAT
TGCGTTGGGAT -> GCGTTGGGATC
GCGTTGGGATC -> CGTTGGGATCC
CGTTGGGATCC -> GTTGGGATCCG
GTTGGGATCCG -> TTGGGATCCGG
TTGGGATCCGG -> TGGGATCCGGT
TGGGATCCGGT -> GGGATCCGGTG
GGGATCCGGTG -> GGATCCGGTGG
GGATCCGGTGG -> GATCCGGTGGG
GATCCGGTGGG -> ATCCGGTGGGT
ATCCGGTGGGT -> TCCGGTGGGTA
TCCGGTGGGTA -> CCGGTGGGTAA
CCGGTGGGTAA -> CGGTGGGTAAC
CGGTGGGTAAC -> GGTGGGTAACT
GGTGGGTAACT -> GTGGGTAACTC
GTGGGTAACTC -> TGGGTAACTCC
TGGGTAACTCC -> GGGTAACTCCG
GGGTAACTCCG -> GGTAACTCCGG
GGTAACTCCGG -> GTAACTCCGGG
GTAACTCCGGG -> TAACTCCGGGG
TAACTCCGGGG -> AACTCCGGGGT
AACTCCGGGGT -> ACTCCGGGGTC
ACTCCGGGGTC -> CTCCGGGGTCC
CTCCGGGGTCC -> TCCGGGGTCCC
TCCGGGGTCCC -> CCGGGGTCCCA
CCGGGGTCCCA -> CGGGGTCCCAA
CGGGGTCCCAA -> GGGGTCCCAAC
GGGGTCCCAAC -> GGGTCCCAACC
GGGTCCCAACC -> GGTCCCAACCG
GGTCCCAACCG -> GTCCCAACCGT
GTCCCAACCGT -> TCCCAACCGTA
TCCCAACCGTA -> CCCAACCGTAA
CCCAACCGTAA -> CCAACCGTAAT
CCAACCGTAAT -> CAACCGTAATA
CAACCGTAATA -> AACCGTAATAG
AACCGTAATAG -> ACCGTAATAGT
ACCGTAATAGT -> CCGTAATAGTG
CCGTAATAGTG -> CGTAATAGTGT
CGTAATAGTGT -> GTAATAGTGTT
GTAATAGTGTT -> TAATAGTGTTA
TAATAGTGTTA -> AATAGTGTTAT
AATAGTGTTAT -> ATAGTGTTATT
ATAGTGTTATT -> TAGTGTTATTA
TAGTGTTATTA -> AGTGTTATTAT
AGTGTTATTAT -> GTGTTATTATC
GTGTTATTATC -> TGTTATTATCG
TGTTATTATCG -> GTTATTATCGC
GTTATTATCGC -> TTATTATCGCC
TTATTATCGCC -> TATTATCGCCA
TATTATCGCCA -> ATTATCGCCAG
ATTATCGCCAG -> TTATCGCCAGT
TTATCGCCAGT -> TATCGCCAGTA
TATCGCCAGTA -> ATCGCCAGTAT
ATCGCCAGTAT -> TCGCCAGTATG
TCGCCAGTATG -> CGCCAGTATGA
CGCCAGTATGA -> GCCAGTATGAA
GCCAGTATGAA -> CCAGTATGAAC
CCAGTATGAAC -> CAGTATGAACA
CAGTATGAACA -> AGTATGAACAG
AGTATGAACAG -> GTATGAACAGT
GTATGAACAGT -> TATGAACAGTT
TATGAACAGTT -> ATGAACAGTTG
ATGAACAGTTG -> TGAACAGTTGC
TGAACAGTTGC -> GAACAGTTGCT
GAACAGTTGCT -> AACAGTTGCTG
AACAGTTGCTG -> ACAGTTGCTGC
ACAGTTGCTGC -> CAGTTGCTGCA
CAGTTGCTGCA -> AGTTGCTGCAA
AGTTGCTGCAA -> GTTGCTGCAAG
GTTGCTGCAAG -> TTGCTGCAAGT
TTGCTGCAAGT -> TGCTGCAAGTG
TGCTGCAAGTG -> GCTGCAAGTGA
GCTGCAAGTGA -> CTGCAAGTGAG
CTGCAAGTGAG -> TGCAAGTGAGC
TGCAAGTGAGC -> GCAAGTGAGCG
GCAAGTGAGCG -> CAAGTGAGCGA
CAAGTGAGCGA -> AAGTGAGCGAG
AAGTGAGCGAG -> AGTGAGCGAGG
AGTGAGCGAGG -> GTGAGCGAGGG
GTGAGCGAGGG -> TGAGCGAGGGT
TGAGCGAGGGT -> GAGCGAGGGTC
GAGCGAGGGTC -> AGCGAGGGTCA
AGCGAGGGTCA -> GCGAGGGTCAA
GCGAGGGTCAA -> CGAGGGTCAAT
CGAGGGTCAAT -> GAGGGTCAATA
GAGGGTCAATA -> AGGGTCAATAA
AGGGTCAATAA -> GGGTCAATAAG
GGGTCAATAAG -> GGTCAATAAGG
GGTCAATAAGG -> GTCAATAAGGC
GTCAATAAGGC -> TCAATAAGGCA
TCAATAAGGCA -> CAATAAGGCAC
CAATAAGGCAC -> AATAAGGCACC
AATAAGGCACC -> ATAAGGCACCT
ATAAGGCACCT -> TAAGGCACCTC
TAAGGCACCTC -> AAGGCACCTCC
AAGGCACCTCC -> AGGCACCTCCA
AGGCACCTCCA -> GGCACCTCCAC
GGCACCTCCAC -> GCACCTCCACT
GCACCTCCACT -> CACCTCCACTC
CACCTCCACTC -> ACCTCCACTCA
CCTCCACTCAC -> CTCCACTCACG
CTCCACTCACG -> TCCACTCACGA
TCCACTCACGA -> CCACTCACGAT
CCACTCACGAT -> CACTCACGATG
CACTCACGATG -> ACTCACGATGC
ACTCACGATGC -> CTCACGATGCT
CTCACGATGCT -> TCACGATGCTT
TCACGATGCTT -> CACGATGCTTT
CACGATGCTTT -> ACGATGCTTTC
ACGATGCTTTC -> CGATGCTTTCA
CGATGCTTTCA -> GATGCTTTCAC
GATGCTTTCAC -> ATGCTTTCACG
ATGCTTTCACG -> TGCTTTCACGT
TGCTTTCACGT -> GCTTTCACGTG
GCTTTCACGTG -> CTTTCACGTGA
CTTTCACGTGA -> TTTCACGTGAT
TTTCACGTGAT -> TTCACGTGATC
TTCACGTGATC -> TCACGTGATCC
TCACGTGATCC -> CACGTGATCCC
CACGTGATCCC -> ACGTGATCCCT
ACGTGATCCCT -> CGTGATCCCTT
CGTGATCCCTT -> GTGATCCCTTA
GTGATCCCTTA -> TGATCCCTTAG
TGATCCCTTAG -> GATCCCTTAGA
GATCCCTTAGA -> ATCCCTTAGAA
ATCCCTTAGAA -> TCCCTTAGAAA
TCCCTTAGAAA -> CCCTTAGAAAG
CCCTTAGAAAG -> CCTTAGAAAGG
CCTTAGAAAGG -> CTTAGAAAGGA
CTTAGAAAGGA -> TTAGAAAGGAT
TTAGAAAGGAT -> TAGAAAGGATC
TAGAAAGGATC -> AGAAAGGATCG
AGAAAGGATCG -> GAAAGGATCGA
GAAAGGATCGA -> AAAGGATCGAT
AAAGGATCGAT -> AAGGATCGATG
AAGGATCGATG -> AGGATCGATGG
AGGATCGATGG -> GGATCGATGGA
GGATCGATGGA -> GATCGATGGAA
GATCGATGGAA -> ATCGATGGAAC
ATCGATGGAAC -> TCGATGGAACC
TCGATGGAACC -> CGATGGAACCC
CGATGGAACCC -> GATGGAACCCG
GATGGAACCCG -> ATGGAACCCGG
ATGGAACCCGG -> TGGAACCCGGA
TGGAACCCGGA -> GGAACCCGGAT
GGAACCCGGAT -> GAACCCGGATG
GAACCCGGATG -> AACCCGGATGA
AACCCGGATGA -> ACCCGGATGAA
ACCCGGATGAA -> CCCGGATGAAG
CCCGGATGAAG -> CCGGATGAAGG
CCGGATGAAGG -> CGGATGAAGGC
CGGATGAAGGC -> GGATGAAGGCC
GGATGAAGGCC -> GATGAAGGCCC
GATGAAGGCCC -> ATGAAGGCCCC
ATGAAGGCCCC -> TGAAGGCCCCG
TGAAGGCCCCG -> GAAGGCCCCGC
GAAGGCCCCGC -> AAGGCCCCGCA
AAGGCCCCGCA -> AGGCCCCGCAG
AGGCCCCGCAG -> GGCCCCGCAGA
GGCCCCGCAGA -> GCCCCGCAGAA
GCCCCGCAGAA -> CCCCGCAGAAG
CCCCGCAGAAG -> CCCGCAGAAGG
CCCGCAGAAGG -> CCGCAGAAGGT
CCGCAGAAGGT -> CGCAGAAGGTC
CGCAGAAGGTC -> GCAGAAGGTCG
GCAGAAGGTCG -> CAGAAGGTCGG
CAGAAGGTCGG -> AGAAGGTCGGT
AGAAGGTCGGT -> GAAGGTCGGTA
GAAGGTCGGTA -> AAGGTCGGTAT
AAGGTCGGTAT -> AGGTCGGTATC
AGGTCGGTATC -> GGTCGGTATCT
GGTCGGTATCT -> GTCGGTATCTA
GTCGGTATCTA -> TCGGTATCTAA
TCGGTATCTAA -> CGGTATCTAAA
CGGTATCTAAA -> GGTATCTAAAC
GGTATCTAAAC -> GTATCTAAACA
GTATCTAAACA -> TATCTAAACAA
TATCTAAACAA -> ATCTAAACAAG
ATCTAAACAAG -> TCTAAACAAGA
TCTAAACAAGA -> CTAAACAAGAC
CTAAACAAGAC -> TAAACAAGACG
TAAACAAGACG -> AAACAAGACGA
AAACAAGACGA -> AACAAGACGAA
AACAAGACGAA -> ACAAGACGAAT
ACAAGACGAAT -> CAAGACGAATG
CAAGACGAATG -> AAGACGAATGA
AAGACGAATGA -> AGACGAATGAG
AGACGAATGAG -> GACGAATGAGC
GACGAATGAGC -> ACGAATGAGCT
ACGAATGAGCT -> CGAATGAGCTG
CGAATGAGCTG -> GAATGAGCTGT
GAATGAGCTGT -> AATGAGCTGTC
AATGAGCTGTC -> ATGAGCTGTCA
ATGAGCTGTCA -> TGAGCTGTCAA
TGAGCTGTCAA -> GAGCTGTCAAC
GAGCTGTCAAC -> AGCTGTCAACT
AGCTGTCAACT -> GCTGTCAACTC
GCTGTCAACTC -> CTGTCAACTCC
CTGTCAACTCC -> TGTCAACTCCA
TGTCAACTCCA -> GTCAACTCCAG
GTCAACTCCAG -> TCAACTCCAGT
TCAACTCCAGT -> CAACTCCAGTT
CAACTCCAGTT -> AACTCCAGTTC
AACTCCAGTTC -> ACTCCAGTTCG
ACTCCAGTTCG -> CTCCAGTTCGA
CTCCAGTTCGA -> TCCAGTTCGAA
TCCAGTTCGAA -> CCAGTTCGAAG
CCAGTTCGAAG -> CAGTTCGAAGA
CAGTTCGAAGA -> AGTTCGAAGAA
AGTTCGAAGAA -> GTTCGAAGAAC
GTTCGAAGAAC -> TTCGAAGAACC
TTCGAAGAACC -> TCGAAGAACCG
TCGAAGAACCG -> CGAAGAACCGT
CGAAGAACCGT -> GAAGAACCGTC
GAAGAACCGTC -> AAGAACCGTCG
AAGAACCGTCG -> AGAACCGTCGA
AGAACCGTCGA -> GAACCGTCGAG
GAACCGTCGAG -> AACCGTCGAGG
AACCGTCGAGG -> ACCGTCGAGGG
ACCGTCGAGGG -> CCGTCGAGGGT
CCGTCGAGGGT -> CGTCGAGGGTG
CGTCGAGGGTG -> GTCGAGGGTGT
GTCGAGGGTGT -> TCGAGGGTGTA
TCGAGGGTGTA -> CGAGGGTGTAA
CGAGGGTGTAA -> GAGGGTGTAAA
GAGGGTGTAAA -> AGGGTGTAAAA
AGGGTGTAAAA -> GGGTGTAAAAA
GGGTGTAAAAA -> GGTGTAAAAAG
GGTGTAAAAAG -> GTGTAAAAAGA
GTGTAAAAAGA -> TGTAAAAAGAT
TGTAAAAAGAT -> GTAAAAAGATC
GTAAAAAGATC -> TAAAAAGATCT
TAAAAAGATCT -> AAAAAGATCTA
AAAAAGATCTA -> AAAAGATCTAG
AAAAGATCTAG -> AAAGATCTAGG
AAAGATCTAGG -> AAGATCTAGGC
AAGATCTAGGC -> AGATCTAGGCA
AGATCTAGGCA -> GATCTAGGCAG
GATCTAGGCAG -> ATCTAGGCAGA
ATCTAGGCAGA -> TCTAGGCAGAA
TCTAGGCAGAA -> CTAGGCAGAAA
CTAGGCAGAAA -> TAGGCAGAAAT
TAGGCAGAAAT -> AGGCAGAAATG
AGGCAGAAATG -> GGCAGAAATGT
GGCAGAAATGT -> GCAGAAATGTT
GCAGAAATGTT -> CAGAAATGTTA
CAGAAATGTTA -> AGAAATGTTAT
AGAAATGTTAT -> GAAATGTTATC
GAAATGTTATC -> AAATGTTATCT
AAATGTTATCT -> AATGTTATCTC
AATGTTATCTC -> ATGTTATCTCG
ATGTTATCTCG -> TGTTATCTCGA
TGTTATCTCGA -> GTTATCTCGAT
GTTATCTCGAT -> TTATCTCGATG
TTATCTCGATG -> TATCTCGATGA
TATCTCGATGA -> ATCTCGATGAG
ATCTCGATGAG -> TCTCGATGAGA
TCTCGATGAGA -> CTCGATGAGAG
CTCGATGAGAG -> TCGATGAGAGT
TCGATGAGAGT -> CGATGAGAGTG
CGATGAGAGTG -> GATGAGAGTGT
GATGAGAGTGT -> ATGAGAGTGTT
ATGAGAGTGTT -> TGAGAGTGTTT
TGAGAGTGTTT -> GAGAGTGTTTA
GAGAGTGTTTA -> AGAGTGTTTAC
AGAGTGTTTAC -> GAGTGTTTACG
GAGTGTTTACG -> AGTGTTTACGA
AGTGTTTACGA -> GTGTTTACGAG
GTGTTTACGAG -> TGTTTACGAGC
TGTTTACGAGC -> GTTTACGAGCC
GTTTACGAGCC -> TTTACGAGCCC
TTTACGAGCCC -> TTACGAGCCCT
TTACGAGCCCT -> TACGAGCCCTC
TACGAGCCCTC -> ACGAGCCCTCT
ACGAGCCCTCT -> CGAGCCCTCTA
CGAGCCCTCTA -> GAGCCCTCTAT
GAGCCCTCTAT -> AGCCCTCTATG
AGCCCTCTATG -> GCCCTCTATGT
GCCCTCTATGT -> CCCTCTATGTT
CCCTCTATGTT -> CCTCTATGTTC
CCTCTATGTTC -> CTCTATGTTCC
CTCTATGTTCC -> TCTATGTTCCC
TCTATGTTCCC -> CTATGTTCCCA
CTATGTTCCCA -> TATGTTCCCAA
TATGTTCCCAA -> ATGTTCCCAAG
ATGTTCCCAAG -> TGTTCCCAAGA
TGTTCCCAAGA -> GTTCCCAAGAT
GTTCCCAAGAT -> TTCCCAAGATA
TTCCCAAGATA -> TCCCAAGATAG
TCCCAAGATAG -> CCCAAGATAGT
CCCAAGATAGT -> CCAAGATAGTC
CCAAGATAGTC -> CAAGATAGTCG
CAAGATAGTCG -> AAGATAGTCGT
AAGATAGTCGT -> AGATAGTCGTC
AGATAGTCGTC -> GATAGTCGTCT
GATAGTCGTCT -> ATAGTCGTCTT
ATAGTCGTCTT -> TAGTCGTCTTG
TAGTCGTCTTG -> AGTCGTCTTGT
AGTCGTCTTGT -> GTCGTCTTGTT
GTCGTCTTGTT -> TCGTCTTGTTA
TCGTCTTGTTA -> CGTCTTGTTAC
CGTCTTGTTAC -> GTCTTGTTACG
GTCTTGTTACG -> TCTTGTTACGT
TCTTGTTACGT -> CTTGTTACGTG
CTTGTTACGTG -> TTGTTACGTGT
TTGTTACGTGT -> TGTTACGTGTT
TGTTACGTGTT -> GTTACGTGTTA
GTTACGTGTTA -> TTACGTGTTAC
TTACGTGTTAC -> TACGTGTTACT
TACGTGTTACT -> ACGTGTTACTG
ACGTGTTACTG -> CGTGTTACTGA
CGTGTTACTGA -> GTGTTACTGAT
GTGTTACTGAT -> TGTTACTGATT
TGTTACTGATT -> GTTACTGATTC
GTTACTGATTC -> TTACTGATTCT
TTACTGATTCT -> TACTGATTCTC
TACTGATTCTC -> ACTGATTCTCT
ACTGATTCTCT -> CTGATTCTCTC
CTGATTCTCTC -> TGATTCTCTCT
TGATTCTCTCT -> GATTCTCTCTA
GATTCTCTCTA -> ATTCTCTCTAG
ATTCTCTCTAG -> TTCTCTCTAGT
TTCTCTCTAGT -> TCTCTCTAGTA
TCTCTCTAGTA -> CTCTCTAGTAA
CTCTCTAGTAA -> TCTCTAGTAAC
TCTCTAGTAAC -> CTCTAGTAACG
CTCTAGTAACG -> TCTAGTAACGC
TCTAGTAACGC -> CTAGTAACGCT
CTAGTAACGCT -> TAGTAACGCTG
TAGTAACGCTG -> AGTAACGCTGT
AGTAACGCTGT -> GTAACGCTGTG
GTAACGCTGTG -> TAACGCTGTGA
TAACGCTGTGA -> AACGCTGTGAT
AACGCTGTGAT -> ACGCTGTGATC
ACGCTGTGATC -> CGCTGTGATCT
CGCTGTGATCT -> GCTGTGATCTT
GCTGTGATCTT -> CTGTGATCTTC
CTGTGATCTTC -> TGTGATCTTCT
TGTGATCTTCT -> GTGATCTTCTC
GTGATCTTCTC -> TGATCTTCTCA
TGATCTTCTCA -> GATCTTCTCAA
GATCTTCTCAA -> ATCTTCTCAAG
ATCTTCTCAAG -> TCTTCTCAAGT
TCTTCTCAAGT -> CTTCTCAAGTA
CTTCTCAAGTA -> TTCTCAAGTAA
TTCTCAAGTAA -> TCTCAAGTAAG
TCTCAAGTAAG -> CTCAAGTAAGT
CTCAAGTAAGT -> TCAAGTAAGTT
TCAAGTAAGTT -> CAAGTAAGTTT
CAAGTAAGTTT -> AAGTAAGTTTC
AAGTAAGTTTC -> AGTAAGTTTCT
AGTAAGTTTCT -> GTAAGTTTCTC
GTAAGTTTCTC -> TAAGTTTCTCG
TAAGTTTCTCG -> AAGTTTCTCGT
AAGTTTCTCGT -> AGTTTCTCGTT
AGTTTCTCGTT -> GTTTCTCGTTC
GTTTCTCGTTC -> TTTCTCGTTCT
TTTCTCGTTCT -> TTCTCGTTCTC
TTCTCGTTCTC -> TCTCGTTCTCA
TCTCGTTCTCA -> CTCGTTCTCAG
CTCGTTCTCAG -> TCGTTCTCAGT
TCGTTCTCAGT -> CGTTCTCAGTT
CGTTCTCAGTT -> GTTCTCAGTTG
GTTCTCAGTTG -> TTCTCAGTTGC
TTCTCAGTTGC -> TCTCAGTTGCG
TCTCAGTTGCG -> CTCAGTTGCGC
CTCAGTTGCGC -> TCAGTTGCGCA
TCAGTTGCGCA -> CAGTTGCGCAA
CAGTTGCGCAA -> AGTTGCGCAAT
AGTTGCGCAAT -> GTTGCGCAATG
GTTGCGCAATG -> TTGCGCAATGA
TTGCGCAATGA -> TGCGCAATGAT
TGCGCAATGAT -> GCGCAATGATA
GCGCAATGATA -> CGCAATGATAC
CGCAATGATAC -> GCAATGATACG
GCAATGATACG -> CAATGATACGA
CAATGATACGA -> AATGATACGAG
AATGATACGAG -> ATGATACGAGT
ATGATACGAGT -> TGATACGAGTA
TGATACGAGTA -> GATACGAGTAA
GATACGAGTAA -> ATACGAGTAAT
ATACGAGTAAT -> TACGAGTAATA
TACGAGTAATA -> ACGAGTAATAA
ACGAGTAATAA -> CGAGTAATAAT
CGAGTAATAAT -> GAGTAATAATG
GAGTAATAATG -> AGTAATAATGA
AGTAATAATGA -> GTAATAATGAC
GTAATAATGAC -> TAATAATGACG
TAATAATGACG -> AATAATGACGT
AATAATGACGT -> ATAATGACGTC
ATAATGACGTC -> TAATGACGTCA
TAATGACGTCA -> AATGACGTCAG
AATGACGTCAG -> ATGACGTCAGA
ATGACGTCAGA -> TGACGTCAGAA
TGACGTCAGAA -> GACGTCAGAAC
GACGTCAGAAC -> ACGTCAGAACG
ACGTCAGAACG -> CGTCAGAACGA
CGTCAGAACGA -> GTCAGAACGAC
GTCAGAACGAC -> TCAGAACGACG
TCAGAACGACG -> CAGAACGACGC
CAGAACGACGC -> AGAACGACGCT
AGAACGACGCT -> GAACGACGCTT
GAACGACGCTT -> AACGACGCTTC
AACGACGCTTC -> ACGACGCTTCA
ACGACGCTTCA -> CGACGCTTCAC
CGACGCTTCAC -> GACGCTTCACA
GACGCTTCACA -> ACGCTTCACAT
ACGCTTCACAT -> CGCTTCACATG
CGCTTCACATG -> GCTTCACATGA
GCTTCACATGA -> CTTCACATGAC
CTTCACATGAC -> TTCACATGACC
TTCACATGACC -> TCACATGACCG
TCACATGACCG -> CACATGACCGC
CACATGACCGC -> ACATGACCGCA
ACATGACCGCA -> CATGACCGCAT
CATGACCGCAT -> ATGACCGCATT
ATGACCGCATT -> TGACCGCATTA
TGACCGCATTA -> GACCGCATTAC
GACCGCATTAC -> ACCGCATTACA
ACCGCATTACA -> CCGCATTACAC
CCGCATTACAC -> CGCATTACACA
CGCATTACACA -> GCATTACACAC
GCATTACACAC -> CATTACACACG
CATTACACACG -> ATTACACACGC
ATTACACACGC -> TTACACACGCG
TTACACACGCG -> TACACACGCGT
TACACACGCGT -> ACACACGCGTT
ACACACGCGTT -> CACACGCGTTT
CACACGCGTTT -> ACACGCGTTTG
ACACGCGTTTG -> CACGCGTTTGA
CACGCGTTTGA -> ACGCGTTTGAA
ACGCGTTTGAA -> CGCGTTTGAAC
CGCGTTTGAAC -> GCGTTTGAACT
GCGTTTGAACT -> CGTTTGAACTT
CGTTTGAACTT -> GTTTGAACTTC
GTTTGAACTTC -> TTTGAACTTCC
TTTGAACTTCC -> TTGAACTTCCG
TTGAACTTCCG -> TGAACTTCCGC
TGAACTTCCGC -> GAACTTCCGCT
GAACTTCCGCT -> AACTTCCGCTT
AACTTCCGCTT -> ACTTCCGCTTG
ACTTCCGCTTG -> CTTCCGCTTGC
CTTCCGCTTGC -> TTCCGCTTGCG
TTCCGCTTGCG -> TCCGCTTGCGC
TCCGCTTGCGC -> CCGCTTGCGCT
CCGCTTGCGCT -> CGCTTGCGCTT
CGCTTGCGCTT -> GCTTGCGCTTC
GCTTGCGCTTC -> CTTGCGCTTCG
CTTGCGCTTCG -> TTGCGCTTCGT
TTGCGCTTCGT -> TGCGCTTCGTA
TGCGCTTCGTA -> GCGCTTCGTAG
GCGCTTCGTAG -> CGCTTCGTAGC
CGCTTCGTAGC -> GCTTCGTAGCT
GCTTCGTAGCT -> CTTCGTAGCTT
CTTCGTAGCTT -> TTCGTAGCTTC
TTCGTAGCTTC -> TCGTAGCTTCA
TCGTAGCTTCA -> CGTAGCTTCAG
CGTAGCTTCAG -> GTAGCTTCAGC
GTAGCTTCAGC -> TAGCTTCAGCG
TAGCTTCAGCG -> AGCTTCAGCGT
AGCTTCAGCGT -> GCTTCAGCGTT
GCTTCAGCGTT -> CTTCAGCGTTC
CTTCAGCGTTC -> TTCAGCGTTCA
TTCAGCGTTCA -> TCAGCGTTCAT
TCAGCGTTCAT -> CAGCGTTCATG
CAGCGTTCATG -> AGCGTTCATGT
AGCGTTCATGT -> GCGTTCATGTT
GCGTTCATGTT -> CGTTCATGTTA
CGTTCATGTTA -> GTTCATGTTAT
GTTCATGTTAT -> TTCATGTTATA
TTCATGTTATA -> TCATGTTATAG
TCATGTTATAG -> CATGTTATAGA
CATGTTATAGA -> ATGTTATAGAT
ATGTTATAGAT -> TGTTATAGATT
TGTTATAGATT -> GTTATAGATTA
GTTATAGATTA -> TTATAGATTAG
TTATAGATTAG -> TATAGATTAGC
TATAGATTAGC -> ATAGATTAGCC
ATAGATTAGCC -> TAGATTAGCCG
TAGATTAGCCG -> AGATTAGCCGT
AGATTAGCCGT -> GATTAGCCGTG
GATTAGCCGTG -> ATTAGCCGTGA
ATTAGCCGTGA -> TTAGCCGTGAC
TTAGCCGTGAC -> TAGCCGTGACA
TAGCCGTGACA -> AGCCGTGACAT
AGCCGTGACAT -> GCCGTGACATC
GCCGTGACATC -> CCGTGACATCC
CCGTGACATCC -> CGTGACATCCC
CGTGACATCCC -> GTGACATCCCA
GTGACATCCCA -> TGACATCCCAG
TGACATCCCAG -> GACATCCCAGT
GACATCCCAGT -> ACATCCCAGTT
ACATCCCAGTT -> CATCCCAGTTT
CATCCCAGTTT -> ATCCCAGTTTC
ATCCCAGTTTC -> TCCCAGTTTCG
TCCCAGTTTCG -> CCCAGTTTCGT
CCCAGTTTCGT -> CCAGTTTCGTA
CCAGTTTCGTA -> CAGTTTCGTAT
CAGTTTCGTAT -> AGTTTCGTATT
AGTTTCGTATT -> GTTTCGTATTT
GTTTCGTATTT -> TTTCGTATTTG
TTTCGTATTTG -> TTCGTATTTGG
TTCGTATTTGG -> TCGTATTTGGA
TCGTATTTGGA -> CGTATTTGGAT
CGTATTTGGAT -> GTATTTGGATT
GTATTTGGATT -> TATTTGGATTT
TATTTGGATTT -> ATTTGGATTTT
ATTTGGATTTT -> TTTGGATTTTA
TTTGGATTTTA -> TTGGATTTTAT
TTGGATTTTAT -> TGGATTTTATT
TGGATTTTATT -> GGATTTTATTA
GGATTTTATTA -> GATTTTATTAC
GATTTTATTAC -> ATTTTATTACA
ATTTTATTACA -> TTTTATTACAA
TTTTATTACAA -> TTTATTACAAG
TTTATTACAAG -> TTATTACAAGC
TTATTACAAGC -> TATTACAAGCT
TATTACAAGCT -> ATTACAAGCTT
ATTACAAGCTT -> TTACAAGCTTA
TTACAAGCTTA -> TACAAGCTTAC
TACAAGCTTAC -> ACAAGCTTACT
ACAAGCTTACT -> CAAGCTTACTA
CAAGCTTACTA -> AAGCTTACTAA
AAGCTTACTAA -> AGCTTACTAAG
AGCTTACTAAG -> GCTTACTAAGG
GCTTACTAAGG -> CTTACTAAGGC
CTTACTAAGGC -> TTACTAAGGCA
TTACTAAGGCA -> TACTAAGGCAA
TACTAAGGCAA -> ACTAAGGCAAT
ACTAAGGCAAT -> CTAAGGCAATG
CTAAGGCAATG -> TAAGGCAATGC
TAAGGCAATGC -> AAGGCAATGCT
AAGGCAATGCT -> AGGCAATGCTC
AGGCAATGCTC -> GGCAATGCTCC
GGCAATGCTCC -> GCAATGCTCCC
GCAATGCTCCC -> CAATGCTCCCT
CAATGCTCCCT -> AATGCTCCCTG
AATGCTCCCTG -> ATGCTCCCTGC
ATGCTCCCTGC -> TGCTCCCTGCG
TGCTCCCTGCG -> GCTCCCTGCGA
GCTCCCTGCGA -> CTCCCTGCGAC
CTCCCTGCGAC -> TCCCTGCGACG
TCCCTGCGACG -> CCCTGCGACGG
CCCTGCGACGG -> CCTGCGACGGG
CCTGCGACGGG -> CTGCGACGGGA
CTGCGACGGGA -> TGCGACGGGAC
TGCGACGGGAC -> GCGACGGGACG
GCGACGGGACG -> CGACGGGACGT
CGACGGGACGT -> GACGGGACGTT
GACGGGACGTT -> ACGGGACGTTG
ACGGGACGTTG -> CGGGACGTTGA
CGGGACGTTGA -> GGGACGTTGAT
GGGACGTTGAT -> GGACGTTGATC
GGACGTTGATC -> GACGTTGATCT
GACGTTGATCT -> ACGTTGATCTA
ACGTTGATCTA -> CGTTGATCTAA
CGTTGATCTAA -> GTTGATCTAAC
GTTGATCTAAC -> TTGATCTAACC
TTGATCTAACC -> TGATCTAACCC
TGATCTAACCC -> GATCTAACCCG
GATCTAACCCG -> ATCTAACCCGT
ATCTAACCCGT -> TCTAACCCGTT
TCTAACCCGTT -> CTAACCCGTTC
CTAACCCGTTC -> TAACCCGTTCA
TAACCCGTTCA -> AACCCGTTCAG
AACCCGTTCAG -> ACCCGTTCAGA
ACCCGTTCAGA -> CCCGTTCAGAA
CCCGTTCAGAA -> CCGTTCAGAAC
CCGTTCAGAAC -> CGTTCAGAACA
CGTTCAGAACA -> GTTCAGAACAT
GTTCAGAACAT -> TTCAGAACATT
TTCAGAACATT -> TCAGAACATTT
TCAGAACATTT -> CAGAACATTTG
CAGAACATTTG -> AGAACATTTGT
AGAACATTTGT -> GAACATTTGTG
GAACATTTGTG -> AACATTTGTGC
AACATTTGTGC -> ACATTTGTGCT
ACATTTGTGCT -> CATTTGTGCTG
CATTTGTGCTG -> ATTTGTGCTGC
ATTTGTGCTGC -> TTTGTGCTGCC
TTTGTGCTGCC -> TTGTGCTGCCA
TTGTGCTGCCA -> TGTGCTGCCAA
TGTGCTGCCAA -> GTGCTGCCAAC
GTGCTGCCAAC -> TGCTGCCAACC
TGCTGCCAACC -> GCTGCCAACCT
GCTGCCAACCT -> CTGCCAACCTG
CTGCCAACCTG -> TGCCAACCTGC
TGCCAACCTGC -> GCCAACCTGCG
GCCAACCTGCG -> CCAACCTGCGC
CCAACCTGCGC -> CAACCTGCGCA
CAACCTGCGCA -> AACCTGCGCAT
AACCTGCGCAT -> ACCTGCGCATG
ACCTGCGCATG -> CCTGCGCATGC
CCTGCGCATGC -> CTGCGCATGCC
CTGCGCATGCC -> TGCGCATGCCG
TGCGCATGCCG -> GCGCATGCCGA
GCGCATGCCGA -> CGCATGCCGAT
CGCATGCCGAT -> GCATGCCGATC
GCATGCCGATC -> CATGCCGATCC
CATGCCGATCC -> ATGCCGATCCG
ATGCCGATCCG -> TGCCGATCCGG
TGCCGATCCGG -> GCCGATCCGGC
GCCGATCCGGC -> CCGATCCGGCC
CCGATCCGGCC -> CGATCCGGCCT
CGATCCGGCCT -> GATCCGGCCTA
GATCCGGCCTA -> ATCCGGCCTAA
ATCCGGCCTAA -> TCCGGCCTAAC
TCCGGCCTAAC -> CCGGCCTAACC
CCGGCCTAACC -> CGGCCTAACCC
CGGCCTAACCC -> GGCCTAACCCC
GGCCTAACCCC -> GCCTAACCCCT
GCCTAACCCCT -> CCTAACCCCTA
CCTAACCCCTA -> CTAACCCCTAA
CTAACCCCTAA -> TAACCCCTAAT
TAACCCCTAAT -> AACCCCTAATG
AACCCCTAATG -> ACCCCTAATGA
ACCCCTAATGA -> CCCCTAATGAC
CCCCTAATGAC -> CCCTAATGACT
CCCTAATGACT -> CCTAATGACTT
CCTAATGACTT -> CTAATGACTTA
CTAATGACTTA -> TAATGACTTAT
TAATGACTTAT -> AATGACTTATG
AATGACTTATG -> ATGACTTATGT
ATGACTTATGT -> TGACTTATGTG
TGACTTATGTG -> GACTTATGTGA
GACTTATGTGA -> ACTTATGTGAG
ACTTATGTGAG -> CTTATGTGAGC
CTTATGTGAGC -> TTATGTGAGCA
TTATGTGAGCA -> TATGTGAGCAC
TATGTGAGCAC -> ATGTGAGCACT
ATGTGAGCACT -> TGTGAGCACTG
TGTGAGCACTG -> GTGAGCACTGG
GTGAGCACTGG -> TGAGCACTGGG
TGAGCACTGGG -> GAGCACTGGGG
GAGCACTGGGG -> AGCACTGGGGA
AGCACTGGGGA -> GCACTGGGGAA
GCACTGGGGAA -> CACTGGGGAAT
CACTGGGGAAT -> ACTGGGGAATC
ACTGGGGAATC -> CTGGGGAATCA
CTGGGGAATCA -> TGGGGAATCAA
TGGGGAATCAA -> GGGGAATCAAC
GGGGAATCAAC -> GGGAATCAACG
GGGAATCAACG -> GGAATCAACGG
GGAATCAACGG -> GAATCAACGGT
GAATCAACGGT -> AATCAACGGTA
AATCAACGGTA -> ATCAACGGTAA
ATCAACGGTAA -> TCAACGGTAAT
TCAACGGTAAT -> CAACGGTAATA
CAACGGTAATA -> AACGGTAATAG
AACGGTAATAG -> ACGGTAATAGA
ACGGTAATAGA -> CGGTAATAGAA
CGGTAATAGAA -> GGTAATAGAAA
GGTAATAGAAA -> GTAATAGAAAC
