AAAAAATCTCCCTGTGGAT -> AAAAATCTCCCTGTGGATT
AAAAACAAAATAGCCCCCT -> AAAACAAAATAGCCCCCTG
AAAAACGGTAAGGCGAGAG -> AAAACGGTAAGGCGAGAGA
AAAAATCTCCCTGTGGATT -> AAAATCTCCCTGTGGATTA
AAAAATTTCTACGTCCTGT -> AAAATTTCTACGTCCTGTA
AAAACAAAATAGCCCCCTG -> AAACAAAATAGCCCCCTGT
AAAACCAAACCGTGGCGAG -> AAACCAAACCGTGGCGAGC
AAAACCATGTTCATCCTGA -> AAACCATGTTCATCCTGAC
AAAACCTAGAGTTCGGCAG -> AAACCTAGAGTTCGGCAGA
AAAACGGTAAGGCGAGAGA -> AAACGGTAAGGCGAGAGAC
AAAAGATTGAGGCTAGTTG -> AAAGATTGAGGCTAGTTGG
AAAATAGCCCCCTGTGGAT -> AAATAGCCCCCTGTGGATT
AAAATCTCCCTGTGGATTA -> AAATCTCCCTGTGGATTAT
AAAATTTCTACGTCCTGTA -> AAATTTCTACGTCCTGTAG
AAACAAAATAGCCCCCTGT -> AACAAAATAGCCCCCTGTG
AAACAACGGTCCTTTGGAT -> AACAACGGTCCTTTGGATT
AAACCAAACCGTGGCGAGC -> AACCAAACCGTGGCGAGCT
AAACCATGTTCATCCTGAC -> AACCATGTTCATCCTGACA
AAACCGTGGCGAGCTCCTG -> AACCGTGGCGAGCTCCTGC
AAACCTAGAGTTCGGCAGA -> AACCTAGAGTTCGGCAGAT
AAACGGTAAGGCGAGAGAC -> AACGGTAAGGCGAGAGACA
AAACGTACTGTTGACAATC -> AACGTACTGTTGACAATCG
AAACTTAGACAAAACCTAG -> AACTTAGACAAAACCTAGA
AAAGAACACCAAGGAGGTC -> AAGAACACCAAGGAGGTCG
AAAGAACGGATCACGGCCC -> AAGAACGGATCACGGCCCA
AAAGATGTAGACATGAAAC -> AAGATGTAGACATGAAACG
AAAGATTGAGGCTAGTTGG -> AAGATTGAGGCTAGTTGGA
AAAGCGCCCGCAATTCGGC -> AAGCGCCCGCAATTCGGCA
AAAGCGTTTAATCCTCAGG -> AAGCGTTTAATCCTCAGGG
AAAGGCCCTTTCGTATCTG -> AAGGCCCTTTCGTATCTGA
AAAGGCCTATCAGAACGCC -> AAGGCCTATCAGAACGCCC
AAAGTGGCAAGGTGGTGAT -> AAGTGGCAAGGTGGTGATG
AAAGTTCATGGCTGTACTT -> AAGTTCATGGCTGTACTTC
AAATAGCCCCCTGTGGATT -> AATAGCCCCCTGTGGATTA
AAATCACATCCAACCGGCT -> AATCACATCCAACCGGCTA
AAATCCCAGACTAGAGATG -> AATCCCAGACTAGAGATGC
AAATCCCTGTCTCGGACAC -> AATCCCTGTCTCGGACACA
AAATCTCCCTGTGGATTAT -> AATCTCCCTGTGGATTATT
AAATTTCTACGTCCTGTAG -> AATTTCTACGTCCTGTAGT
AACAAAATAGCCCCCTGTG -> ACAAAATAGCCCCCTGTGG
AACAACCGGAGGGCTCACG -> ACAACCGGAGGGCTCACGC
AACAACGGTCCTTTGGATT -> ACAACGGTCCTTTGGATTA
AACAATCCTCACCCGTCCA -> ACAATCCTCACCCGTCCAA
AACACAGGTGTACGCTCAT -> ACACAGGTGTACGCTCATT
AACACCAAGGAGGTCGAGT -> ACACCAAGGAGGTCGAGTA
AACACGTAGTAAACAACGG -> ACACGTAGTAAACAACGGT
AACAGTAAAACCATGTTCA -> ACAGTAAAACCATGTTCAT
AACCAAACCGTGGCGAGCT -> ACCAAACCGTGGCGAGCTC
AACCATGTTCATCCTGACA -> ACCATGTTCATCCTGACAC
AACCATTAAAAATTTCTAC -> ACCATTAAAAATTTCTACG
AACCGGAGGGCTCACGCCC -> ACCGGAGGGCTCACGCCCT
AACCGGCTAGATTAGGGGA -> ACCGGCTAGATTAGGGGAC
AACCGTGGCGAGCTCCTGC -> ACCGTGGCGAGCTCCTGCG
AACCTAGAGTTCGGCAGAT -> ACCTAGAGTTCGGCAGATG
AACCTTAGCTGGCGTTAGA -> ACCTTAGCTGGCGTTAGAG
AACGACAAGACGTGCATTT -> ACGACAAGACGTGCATTTG
AACGCCCTCAACCATTAAA -> ACGCCCTCAACCATTAAAA
AACGGATCACGGCCCACCG -> ACGGATCACGGCCCACCGA
AACGGGTGGTTTATCGGGG -> ACGGGTGGTTTATCGGGGA
AACGGTAAGGCGAGAGACA -> ACGGTAAGGCGAGAGACAC
AACGGTCCTTTGGATTACA -> ACGGTCCTTTGGATTACAT
AACGTACTGTTGACAATCG -> ACGTACTGTTGACAATCGC
AACGTATAAAGTGGCAAGG -> ACGTATAAAGTGGCAAGGT
AACTCACAGTTTAATCATA -> ACTCACAGTTTAATCATAA
AACTCAGTCATTCATCATA -> ACTCAGTCATTCATCATAT
AACTTAGACAAAACCTAGA -> ACTTAGACAAAACCTAGAG
AAGAACACCAAGGAGGTCG -> AGAACACCAAGGAGGTCGA
AAGAACGGATCACGGCCCA -> AGAACGGATCACGGCCCAC
AAGAATAGGTTGTAGAATT -> AGAATAGGTTGTAGAATTT
AAGACCTACAGACGGCGTT -> AGACCTACAGACGGCGTTG
AAGACGAAATCCCTGTCTC -> AGACGAAATCCCTGTCTCG
AAGACGTGCATTTGAAGAC -> AGACGTGCATTTGAAGACC
AAGAGACACCAGGAGTGCG -> AGAGACACCAGGAGTGCGG
AAGAGCATTTTTGTCCGGG -> AGAGCATTTTTGTCCGGGG
AAGATCTTAGCTGAGCACT -> AGATCTTAGCTGAGCACTT
AAGATGTAGACATGAAACG -> AGATGTAGACATGAAACGT
AAGATTGAGGCTAGTTGGA -> AGATTGAGGCTAGTTGGAT
AAGCAGCTTTCGCGGCCCG -> AGCAGCTTTCGCGGCCCGT
AAGCCAACAGTAAAACCAT -> AGCCAACAGTAAAACCATG
AAGCCCGACTTTGTAATTG -> AGCCCGACTTTGTAATTGT
AAGCGATTTCCACTGTGCG -> AGCGATTTCCACTGTGCGT
AAGCGCCCGCAATTCGGCA -> AGCGCCCGCAATTCGGCAC
AAGCGTTTAATCCTCAGGG -> AGCGTTTAATCCTCAGGGT
AAGCTGGCTATTCGTACGG -> AGCTGGCTATTCGTACGGC
AAGCTTAGCTGAGCACTTG -> AGCTTAGCTGAGCACTTGC
AAGGACAGTCGTTCTTGGT -> AGGACAGTCGTTCTTGGTT
AAGGAGGTCGAGTAGTGTG -> AGGAGGTCGAGTAGTGTGG
AAGGCCCTTTCGTATCTGA -> AGGCCCTTTCGTATCTGAG
AAGGCCTATCAGAACGCCC -> AGGCCTATCAGAACGCCCT
AAGGCGAGAGACACTCTTC -> AGGCGAGAGACACTCTTCA
AAGGCGATCATGCGTTACG -> AGGCGATCATGCGTTACGT
AAGGCTCCATCTTCACAGT -> AGGCTCCATCTTCACAGTC
AAGGCTCGGTGAGCGGTTA -> AGGCTCGGTGAGCGGTTAT
AAGGGGATTTAGCCGCGAC -> AGGGGATTTAGCCGCGACG
AAGGGGTACACGGGTGGTG -> AGGGGTACACGGGTGGTGA
AAGGTGGTGATGTGCAACA -> AGGTGGTGATGTGCAACAC
AAGGTTAATTCCTAGTATG -> AGGTTAATTCCTAGTATGT
AAGTATCTATATCTTAGCC -> AGTATCTATATCTTAGCCG
AAGTCTCGGGATGTAGGAA -> AGTCTCGGGATGTAGGAAA
AAGTGGCAAGGTGGTGATG -> AGTGGCAAGGTGGTGATGT
AAGTGTCTGGCCAGAGGAG -> AGTGTCTGGCCAGAGGAGT
AAGTGTGCTAAGAATAGGT -> AGTGTGCTAAGAATAGGTT
AAGTGTTGGTCGTCAATCA -> AGTGTTGGTCGTCAATCAA
AAGTTCATGGCTGTACTTC -> AGTTCATGGCTGTACTTCA
AAGTTCGGCCTGGGAGCAC -> AGTTCGGCCTGGGAGCACC
AAGTTTCCCGTAGATACTT -> AGTTTCCCGTAGATACTTC
AATAACGGGTGGTTTATCG -> ATAACGGGTGGTTTATCGG
AATACACCGTGATCAGACC -> ATACACCGTGATCAGACCT
AATAGCCCCCTGTGGATTA -> ATAGCCCCCTGTGGATTAT
AATAGGGAGACTTCCAGAT -> ATAGGGAGACTTCCAGATG
AATAGGTTGTAGAATTTTG -> ATAGGTTGTAGAATTTTGG
AATCAATTCGGACCACTTA -> ATCAATTCGGACCACTTAT
AATCACAATTTTTTACCCT -> ATCACAATTTTTTACCCTT
AATCACATCCAACCGGCTA -> ATCACATCCAACCGGCTAG
AATCACGTCATTATGCCCC -> ATCACGTCATTATGCCCCC
AATCATAAAAACAAAATAG -> ATCATAAAAACAAAATAGC
AATCCCAGACTAGAGATGC -> ATCCCAGACTAGAGATGCA
AATCCCTGTCTCGGACACA -> ATCCCTGTCTCGGACACAT
AATCCTAGAAAGATGTAGA -> ATCCTAGAAAGATGTAGAC
AATCCTCACCCGTCCAAAA -> ATCCTCACCCGTCCAAAAA
AATCCTCAGGGTCAAGGCT -> ATCCTCAGGGTCAAGGCTC
AATCGCTAATAGGGAGACT -> ATCGCTAATAGGGAGACTT
AATCGCTACCTTTACTCCT -> ATCGCTACCTTTACTCCTA
AATCTCCCTGTGGATTATT -> ATCTCCCTGTGGATTATTC
AATCTGTTGGAGAGCTGTG -> ATCTGTTGGAGAGCTGTGT
AATGCAAAGCGTTTAATCC -> ATGCAAAGCGTTTAATCCT
AATGCGATGGACTTCGAAT -> ATGCGATGGACTTCGAATC
AATTACATTCAGCGTGCCA -> ATTACATTCAGCGTGCCAA
AATTAGATTCGGTCCTAGA -> ATTAGATTCGGTCCTAGAA
AATTCCTAGTATGTTGACG -> ATTCCTAGTATGTTGACGG
AATTCGCTCGATCGTAAGC -> ATTCGCTCGATCGTAAGCG
AATTCGGACCACTTATATC -> ATTCGGACCACTTATATCG
AATTCGGCACCCTGGCACG -> ATTCGGCACCCTGGCACGG
AATTCGTCCTTCCTATCAA -> ATTCGTCCTTCCTATCAAT
AATTCTGTAGCAAGTCTCG -> ATTCTGTAGCAAGTCTCGG
AATTGTTTCGCTTTAGTCA -> ATTGTTTCGCTTTAGTCAA
AATTTCTACGTCCTGTAGT -> ATTTCTACGTCCTGTAGTC
AATTTTGGAAACTTAGACA -> ATTTTGGAAACTTAGACAA
AATTTTTTACCCTTGGGAG -> ATTTTTTACCCTTGGGAGG
ACAAAACCTAGAGTTCGGC -> CAAAACCTAGAGTTCGGCA
ACAAAATAGCCCCCTGTGG -> CAAAATAGCCCCCTGTGGA
ACAACCGGAGGGCTCACGC -> CAACCGGAGGGCTCACGCC
ACAACGGTCCTTTGGATTA -> CAACGGTCCTTTGGATTAC
ACAAGACGAAATCCCTGTC -> CAAGACGAAATCCCTGTCT
ACAAGACGTGCATTTGAAG -> CAAGACGTGCATTTGAAGA
ACAAGTTCGGCCTGGGAGC -> CAAGTTCGGCCTGGGAGCA
ACAATCCTCACCCGTCCAA -> CAATCCTCACCCGTCCAAA
ACAATCGCTAATAGGGAGA -> CAATCGCTAATAGGGAGAC
ACAATTACATTCAGCGTGC -> CAATTACATTCAGCGTGCC
ACAATTTTTTACCCTTGGG -> CAATTTTTTACCCTTGGGA
ACACAAGACGAAATCCCTG -> CACAAGACGAAATCCCTGT
ACACAGGTGTACGCTCATT -> CACAGGTGTACGCTCATTC
ACACATTGAGTCGCGCAGT -> CACATTGAGTCGCGCAGTG
ACACCAAGGAGGTCGAGTA -> CACCAAGGAGGTCGAGTAG
ACACCAGGAGTGCGGTGGC -> CACCAGGAGTGCGGTGGCA
ACACCGTGATCAGACCTGC -> CACCGTGATCAGACCTGCT
ACACGCAGAATTAGATTCG -> CACGCAGAATTAGATTCGG
ACACGGGTGGTGACTTGGG -> CACGGGTGGTGACTTGGGC
ACACGTAGTAAACAACGGT -> CACGTAGTAAACAACGGTC
ACACTCGAAAGAACGGATC -> CACTCGAAAGAACGGATCA
ACACTCTTCAGACTCGTTC -> CACTCTTCAGACTCGTTCT
ACAGACGGCGTTGCACTCA -> CAGACGGCGTTGCACTCAG
ACAGATGTAAGTGTTGGTC -> CAGATGTAAGTGTTGGTCG
ACAGCCAATACACCGTGAT -> CAGCCAATACACCGTGATC
ACAGGTGTACGCTCATTCA -> CAGGTGTACGCTCATTCAA
ACAGTAAAACCATGTTCAT -> CAGTAAAACCATGTTCATC
ACAGTCACACGCAGAATTA -> CAGTCACACGCAGAATTAG
ACAGTCGTTCTTGGTTGCT -> CAGTCGTTCTTGGTTGCTT
ACAGTTTAATCATAAAAAC -> CAGTTTAATCATAAAAACA
ACATAGAAGGACAGTCGTT -> CATAGAAGGACAGTCGTTC
ACATCAACAATCCTCACCC -> CATCAACAATCCTCACCCG
ACATCCAACCGGCTAGATT -> CATCCAACCGGCTAGATTA
ACATGAAACGTACTGTTGA -> CATGAAACGTACTGTTGAC
ACATGTTGCCCCCCGGCCC -> CATGTTGCCCCCCGGCCCG
ACATTCAGCGTGCCAATAA -> CATTCAGCGTGCCAATAAC
ACATTGAGTCGCGCAGTGA -> CATTGAGTCGCGCAGTGAA
ACATTGTCTAAGGTTAATT -> CATTGTCTAAGGTTAATTC
ACCAAACCGTGGCGAGCTC -> CCAAACCGTGGCGAGCTCC
ACCAAGGAGGTCGAGTAGT -> CCAAGGAGGTCGAGTAGTG
ACCACTTATATCGATTATC -> CCACTTATATCGATTATCT
ACCAGGAGTGCGGTGGCAT -> CCAGGAGTGCGGTGGCATT
ACCAGTAAGAGACACCAGG -> CCAGTAAGAGACACCAGGA
ACCATGTTCATCCTGACAC -> CCATGTTCATCCTGACACT
ACCATTAAAAATTTCTACG -> CCATTAAAAATTTCTACGT
ACCCACTAGAATTCTGTAG -> CCCACTAGAATTCTGTAGC
ACCCGTCCAAAAACGGTAA -> CCCGTCCAAAAACGGTAAG
ACCCTGGCACGGTAACACG -> CCCTGGCACGGTAACACGT
ACCCTGTGGATTATTCCCC -> CCCTGTGGATTATTCCCCA
ACCCTTGGGAGGGGACCAG -> CCCTTGGGAGGGGACCAGT
ACCGAACAACCGGAGGGCT -> CCGAACAACCGGAGGGCTC
ACCGGAGGGCTCACGCCCT -> CCGGAGGGCTCACGCCCTG
ACCGGCTAGATTAGGGGAC -> CCGGCTAGATTAGGGGACG
ACCGTGATCAGACCTGCTC -> CCGTGATCAGACCTGCTCC
ACCGTGGCGAGCTCCTGCG -> CCGTGGCGAGCTCCTGCGC
ACCTACAGACGGCGTTGCA -> CCTACAGACGGCGTTGCAC
ACCTAGAGTTCGGCAGATG -> CCTAGAGTTCGGCAGATGG
ACCTATTCCCCTTATGGTG -> CCTATTCCCCTTATGGTGG
ACCTCACAGCCAATACACC -> CCTCACAGCCAATACACCG
ACCTCGGTCCTACTCCGCA -> CCTCGGTCCTACTCCGCAT
ACCTGCTCCAAGTGTCTGG -> CCTGCTCCAAGTGTCTGGC
ACCTGGTTTTGGCTGGTGG -> CCTGGTTTTGGCTGGTGGT
ACCTTAGCTGGCGTTAGAG -> CCTTAGCTGGCGTTAGAGC
ACCTTTACTCCTAACCTTA -> CCTTTACTCCTAACCTTAG
ACGAAATCCCTGTCTCGGA -> CGAAATCCCTGTCTCGGAC
ACGAAGTTTCCCGTAGATA -> CGAAGTTTCCCGTAGATAC
ACGACAAGACGTGCATTTG -> CGACAAGACGTGCATTTGA
ACGATTATCGCGGGTGACG -> CGATTATCGCGGGTGACGC
ACGCACCTCACAGCCAATA -> CGCACCTCACAGCCAATAC
ACGCAGAATTAGATTCGGT -> CGCAGAATTAGATTCGGTC
ACGCCCTCAACCATTAAAA -> CGCCCTCAACCATTAAAAA
ACGCCCTGTGGATTATTCC -> CGCCCTGTGGATTATTCCC
ACGCGCCGGCTGACACAAG -> CGCGCCGGCTGACACAAGA
ACGCTCATTCAAAGAACAC -> CGCTCATTCAAAGAACACC
ACGGACTTATTGGGCCTTT -> CGGACTTATTGGGCCTTTA
ACGGATCACGGCCCACCGA -> CGGATCACGGCCCACCGAA
ACGGATTTCCTTTTGGTTA -> CGGATTTCCTTTTGGTTAT
ACGGCAGGGGTTGAATTCG -> CGGCAGGGGTTGAATTCGT
ACGGCCCACCGAACAACCG -> CGGCCCACCGAACAACCGG
ACGGCGTTGCACTCAGTAA -> CGGCGTTGCACTCAGTAAA
ACGGGGACATGTTGCCCCC -> CGGGGACATGTTGCCCCCC
ACGGGGTATTGCCCTAGAA -> CGGGGTATTGCCCTAGAAA
ACGGGTGGTGACTTGGGCG -> CGGGTGGTGACTTGGGCGG
ACGGGTGGTTTATCGGGGA -> CGGGTGGTTTATCGGGGAT
ACGGTAACACGTAGTAAAC -> CGGTAACACGTAGTAAACA
ACGGTAAGGCGAGAGACAC -> CGGTAAGGCGAGAGACACT
ACGGTCCTTTGGATTACAT -> CGGTCCTTTGGATTACATT
ACGGTTGCAGAATCTGTTG -> CGGTTGCAGAATCTGTTGG
ACGTAATGCAAAGCGTTTA -> CGTAATGCAAAGCGTTTAA
ACGTACTGTTGACAATCGC -> CGTACTGTTGACAATCGCT
ACGTAGTAAACAACGGTCC -> CGTAGTAAACAACGGTCCT
ACGTATAAAGTGGCAAGGT -> CGTATAAAGTGGCAAGGTG
ACGTCATTATGCCCCCTTG -> CGTCATTATGCCCCCTTGC
ACGTCCTGTAGTCTTCGTG -> CGTCCTGTAGTCTTCGTGT
ACGTGCATTTGAAGACCTA -> CGTGCATTTGAAGACCTAC
ACTACCTGGTTTTGGCTGG -> CTACCTGGTTTTGGCTGGT
ACTAGAATTCTGTAGCAAG -> CTAGAATTCTGTAGCAAGT
ACTAGAGATGCACTGTGAC -> CTAGAGATGCACTGTGACC
ACTATATCTAGGGAAGCAG -> CTATATCTAGGGAAGCAGC
ACTCACAGTTTAATCATAA -> CTCACAGTTTAATCATAAA
ACTCAGTAAAGCGCCCGCA -> CTCAGTAAAGCGCCCGCAA
ACTCAGTCATTCATCATAT -> CTCAGTCATTCATCATATA
ACTCCCCAGGCTTAGCTGA -> CTCCCCAGGCTTAGCTGAG
ACTCCGCATAGCATGACAG -> CTCCGCATAGCATGACAGA
ACTCCTAACCTTAGCTGGC -> CTCCTAACCTTAGCTGGCG
ACTCGAAAGAACGGATCAC -> CTCGAAAGAACGGATCACG
ACTCGCCATGTCTTAGCTG -> CTCGCCATGTCTTAGCTGA
ACTCGTTCTGCACATAGAA -> CTCGTTCTGCACATAGAAG
ACTCTTCAGACTCGTTCTG -> CTCTTCAGACTCGTTCTGC
ACTGTGACCCACTAGAATT -> CTGTGACCCACTAGAATTC
ACTGTGCGTAGACGGACTT -> CTGTGCGTAGACGGACTTA
ACTGTTGACAATCGCTAAT -> CTGTTGACAATCGCTAATA
ACTTAGACAAAACCTAGAG -> CTTAGACAAAACCTAGAGT
ACTTATATCGATTATCTTG -> CTTATATCGATTATCTTGG
ACTTATTGGGCCTTTAAAA -> CTTATTGGGCCTTTAAAAC
ACTTCAGTTCTAGCCTTAA -> CTTCAGTTCTAGCCTTAAG
ACTTCCAGATGTCTAGGAC -> CTTCCAGATGTCTAGGACG
ACTTCCTGATCGTACGATT -> CTTCCTGATCGTACGATTA
ACTTCGAATCACAATTTTT -> CTTCGAATCACAATTTTTT
ACTTGCCGCGGGAGGCAAA -> CTTGCCGCGGGAGGCAAAA
ACTTGCCGCTCGTTACTAC -> CTTGCCGCTCGTTACTACC
ACTTGCCGGACCTCGGTCC -> CTTGCCGGACCTCGGTCCT
ACTTGCCGTGCCGTTAGAA -> CTTGCCGTGCCGTTAGAAC
ACTTGGGCGGTGCGTAGAG -> CTTGGGCGGTGCGTAGAGT
ACTTTGTAATTGTTTCGCT -> CTTTGTAATTGTTTCGCTT
AGAAAAAATCTCCCTGTGG -> GAAAAAATCTCCCTGTGGA
AGAAAGATGTAGACATGAA -> GAAAGATGTAGACATGAAA
AGAACACCAAGGAGGTCGA -> GAACACCAAGGAGGTCGAG
AGAACGACAAGACGTGCAT -> GAACGACAAGACGTGCATT
AGAACGCCCTCAACCATTA -> GAACGCCCTCAACCATTAA
AGAACGGATCACGGCCCAC -> GAACGGATCACGGCCCACC
AGAACGTATAAAGTGGCAA -> GAACGTATAAAGTGGCAAG
AGAAGCTTAGCTGAGCACT -> GAAGCTTAGCTGAGCACTT
AGAAGGACAGTCGTTCTTG -> GAAGGACAGTCGTTCTTGG
AGAATAGGTTGTAGAATTT -> GAATAGGTTGTAGAATTTT
AGAATCTGTTGGAGAGCTG -> GAATCTGTTGGAGAGCTGT
AGAATTAGATTCGGTCCTA -> GAATTAGATTCGGTCCTAG
AGAATTCTGTAGCAAGTCT -> GAATTCTGTAGCAAGTCTC
AGAATTTTGGAAACTTAGA -> GAATTTTGGAAACTTAGAC
AGACAAAACCTAGAGTTCG -> GACAAAACCTAGAGTTCGG
AGACACCAGGAGTGCGGTG -> GACACCAGGAGTGCGGTGG
AGACACTCTTCAGACTCGT -> GACACTCTTCAGACTCGTT
AGACATGAAACGTACTGTT -> GACATGAAACGTACTGTTG
AGACCTACAGACGGCGTTG -> GACCTACAGACGGCGTTGC
AGACCTATTCCCCTTATGG -> GACCTATTCCCCTTATGGT
AGACCTGCTCCAAGTGTCT -> GACCTGCTCCAAGTGTCTG
AGACGAAATCCCTGTCTCG -> GACGAAATCCCTGTCTCGG
AGACGGACTTATTGGGCCT -> GACGGACTTATTGGGCCTT
AGACGGCGTTGCACTCAGT -> GACGGCGTTGCACTCAGTA
AGACGTGCATTTGAAGACC -> GACGTGCATTTGAAGACCT
AGACTAGAGATGCACTGTG -> GACTAGAGATGCACTGTGA
AGACTCGTTCTGCACATAG -> GACTCGTTCTGCACATAGA
AGACTTCCAGATGTCTAGG -> GACTTCCAGATGTCTAGGA
AGAGAAGCTTAGCTGAGCA -> GAGAAGCTTAGCTGAGCAC
AGAGACACCAGGAGTGCGG -> GAGACACCAGGAGTGCGGT
AGAGACACTCTTCAGACTC -> GAGACACTCTTCAGACTCG
AGAGATGCACTGTGACCCA -> GAGATGCACTGTGACCCAC
AGAGCATCTGCCTTCATTC -> GAGCATCTGCCTTCATTCG
AGAGCATTTTTGTCCGGGG -> GAGCATTTTTGTCCGGGGG
AGAGCTGTGTCAGGGATTG -> GAGCTGTGTCAGGGATTGG
AGAGGAGTGGAGATATAAT -> GAGGAGTGGAGATATAATC
AGAGTTCGGCAGATGGCCC -> GAGTTCGGCAGATGGCCCT
AGATACTTCCTGATCGTAC -> GATACTTCCTGATCGTACG
AGATATAATCCTAGAAAGA -> GATATAATCCTAGAAAGAT
AGATCTTAGCTGAGCACTT -> GATCTTAGCTGAGCACTTG
AGATGCACTGTGACCCACT -> GATGCACTGTGACCCACTA
AGATGGCCCTTAAGCTGGC -> GATGGCCCTTAAGCTGGCT
AGATGTAAGTGTTGGTCGT -> GATGTAAGTGTTGGTCGTC
AGATGTAGACATGAAACGT -> GATGTAGACATGAAACGTA
AGATGTCTAGGACGCGCCG -> GATGTCTAGGACGCGCCGG
AGATTAGGGGACGGATTTC -> GATTAGGGGACGGATTTCC
AGATTCGGTCCTAGAACGT -> GATTCGGTCCTAGAACGTA
AGATTGAGGCTAGTTGGAT -> GATTGAGGCTAGTTGGATG
AGCAAGTCTCGGGATGTAG -> GCAAGTCTCGGGATGTAGG
AGCACCCTGTGGATTATTC -> GCACCCTGTGGATTATTCC
AGCACTTGCCGCGGGAGGC -> GCACTTGCCGCGGGAGGCA
AGCACTTGCCGCTCGTTAC -> GCACTTGCCGCTCGTTACT
AGCACTTGCCGGACCTCGG -> GCACTTGCCGGACCTCGGT
AGCACTTGCCGTGCCGTTA -> GCACTTGCCGTGCCGTTAG
AGCAGCTTTCGCGGCCCGT -> GCAGCTTTCGCGGCCCGTA
AGCATCTGCCTTCATTCGT -> GCATCTGCCTTCATTCGTC
AGCATGACAGATGTAAGTG -> GCATGACAGATGTAAGTGT
AGCATTTTTGTCCGGGGGG -> GCATTTTTGTCCGGGGGGT
AGCCAACAGTAAAACCATG -> GCCAACAGTAAAACCATGT
AGCCAATACACCGTGATCA -> GCCAATACACCGTGATCAG
AGCCCCCTGTGGATTATTC -> GCCCCCTGTGGATTATTCC
AGCCCGACTTTGTAATTGT -> GCCCGACTTTGTAATTGTT
AGCCGCGACGAAGTTTCCC -> GCCGCGACGAAGTTTCCCG
AGCCGGGCACAATTACATT -> GCCGGGCACAATTACATTC
AGCCTTAAGGCTCGGTGAG -> GCCTTAAGGCTCGGTGAGC
AGCGATTTCCACTGTGCGT -> GCGATTTCCACTGTGCGTA
AGCGCCCGCAATTCGGCAC -> GCGCCCGCAATTCGGCACC
AGCGGCGGCCGTTGATCGA -> GCGGCGGCCGTTGATCGAC
AGCGGTTATCACAAGTTCG -> GCGGTTATCACAAGTTCGG
AGCGTGCCAATAACGGGTG -> GCGTGCCAATAACGGGTGG
AGCGTTTAATCCTCAGGGT -> GCGTTTAATCCTCAGGGTC
AGCTCCTGCGCCCGAAGGC -> GCTCCTGCGCCCGAAGGCG
AGCTGAGCACTTGCCGCGG -> GCTGAGCACTTGCCGCGGG
AGCTGAGCACTTGCCGCTC -> GCTGAGCACTTGCCGCTCG
AGCTGAGCACTTGCCGGAC -> GCTGAGCACTTGCCGGACC
AGCTGAGCACTTGCCGTGC -> GCTGAGCACTTGCCGTGCC
AGCTGGCGTTAGAGCATCT -> GCTGGCGTTAGAGCATCTG
AGCTGGCTATTCGTACGGC -> GCTGGCTATTCGTACGGCA
AGCTGTGTCAGGGATTGGG -> GCTGTGTCAGGGATTGGGG
AGCTTAGCTGAGCACTTGC -> GCTTAGCTGAGCACTTGCC
AGCTTGCCAGGCGAACTCA -> GCTTGCCAGGCGAACTCAG
AGCTTTCGCGGCCCGTACG -> GCTTTCGCGGCCCGTACGG
AGGAAAGGCCCTTTCGTAT -> GGAAAGGCCCTTTCGTATC
AGGACAGTCGTTCTTGGTT -> GGACAGTCGTTCTTGGTTG
AGGACGCGCCGGCTGACAC -> GGACGCGCCGGCTGACACA
AGGAGGTCGAGTAGTGTGG -> GGAGGTCGAGTAGTGTGGA
AGGAGTGCGGTGGCATTAA -> GGAGTGCGGTGGCATTAAG
AGGAGTGGAGATATAATCC -> GGAGTGGAGATATAATCCT
AGGCAAAAGATTGAGGCTA -> GGCAAAAGATTGAGGCTAG
AGGCCCTTTCGTATCTGAG -> GGCCCTTTCGTATCTGAGC
AGGCCTATCAGAACGCCCT -> GGCCTATCAGAACGCCCTC
AGGCGAACTCAGTCATTCA -> GGCGAACTCAGTCATTCAT
AGGCGAGAGACACTCTTCA -> GGCGAGAGACACTCTTCAG
AGGCGATCATGCGTTACGT -> GGCGATCATGCGTTACGTA
AGGCTAGTTGGATGCTGTT -> GGCTAGTTGGATGCTGTTG
AGGCTCCATCTTCACAGTC -> GGCTCCATCTTCACAGTCA
AGGCTCGGTGAGCGGTTAT -> GGCTCGGTGAGCGGTTATC
AGGCTTAGCTGAGCACTTG -> GGCTTAGCTGAGCACTTGC
AGGGAAGCAGCTTTCGCGG -> GGGAAGCAGCTTTCGCGGC
AGGGAGACTTCCAGATGTC -> GGGAGACTTCCAGATGTCT
AGGGATTGGGGGGCAAAGT -> GGGATTGGGGGGCAAAGTT
AGGGCTCACGCCCTGTGGA -> GGGCTCACGCCCTGTGGAT
AGGGGACCAGTAAGAGACA -> GGGGACCAGTAAGAGACAC
AGGGGACGGATTTCCTTTT -> GGGGACGGATTTCCTTTTG
AGGGGATTTAGCCGCGACG -> GGGGATTTAGCCGCGACGA
AGGGGTACACGGGTGGTGA -> GGGGTACACGGGTGGTGAC
AGGGGTCTAAGTGTGCTAA -> GGGGTCTAAGTGTGCTAAG
AGGGGTTGAATTCGTCCTT -> GGGGTTGAATTCGTCCTTC
AGGGTCAAGGCTCCATCTT -> GGGTCAAGGCTCCATCTTC
AGGTCGAGTAGTGTGGATA -> GGTCGAGTAGTGTGGATAC
AGGTGGTGATGTGCAACAC -> GGTGGTGATGTGCAACACA
AGGTGTACGCTCATTCAAA -> GGTGTACGCTCATTCAAAG
AGGTTAATTCCTAGTATGT -> GGTTAATTCCTAGTATGTT
AGGTTGTAGAATTTTGGAA -> GGTTGTAGAATTTTGGAAA
AGTAAAACCATGTTCATCC -> GTAAAACCATGTTCATCCT
AGTAAACAACGGTCCTTTG -> GTAAACAACGGTCCTTTGG
AGTAAAGCGCCCGCAATTC -> GTAAAGCGCCCGCAATTCG
AGTAAGAGACACCAGGAGT -> GTAAGAGACACCAGGAGTG
AGTAGTGTGGATACTATAT -> GTAGTGTGGATACTATATC
AGTATCTATATCTTAGCCG -> GTATCTATATCTTAGCCGG
AGTATGTTGACGGTTGCAG -> GTATGTTGACGGTTGCAGA
AGTCAAGAGCATTTTTGTC -> GTCAAGAGCATTTTTGTCC
AGTCACACGCAGAATTAGA -> GTCACACGCAGAATTAGAT
AGTCATTCATCATATATAT -> GTCATTCATCATATATATC
AGTCGCGCAGTGAACTCAC -> GTCGCGCAGTGAACTCACA
AGTCGTTCTTGGTTGCTTA -> GTCGTTCTTGGTTGCTTAG
AGTCTCGGGATGTAGGAAA -> GTCTCGGGATGTAGGAAAG
AGTCTTCGTGTAAGCCAAC -> GTCTTCGTGTAAGCCAACA
AGTGAACTCACAGTTTAAT -> GTGAACTCACAGTTTAATC
AGTGCGGTGGCATTAAGGG -> GTGCGGTGGCATTAAGGGG
AGTGGAGATATAATCCTAG -> GTGGAGATATAATCCTAGA
AGTGGCAAGGTGGTGATGT -> GTGGCAAGGTGGTGATGTG
AGTGTCTGGCCAGAGGAGT -> GTGTCTGGCCAGAGGAGTG
AGTGTGCTAAGAATAGGTT -> GTGTGCTAAGAATAGGTTG
AGTGTGGATACTATATCTA -> GTGTGGATACTATATCTAG
AGTGTTGGTCGTCAATCAA -> GTGTTGGTCGTCAATCAAT
AGTTCATGGCTGTACTTCA -> GTTCATGGCTGTACTTCAG
AGTTCGGCAGATGGCCCTT -> GTTCGGCAGATGGCCCTTA
AGTTCGGCCTGGGAGCACC -> GTTCGGCCTGGGAGCACCC
AGTTCTAGCCTTAAGGCTC -> GTTCTAGCCTTAAGGCTCG
AGTTGGATGCTGTTGGTAA -> GTTGGATGCTGTTGGTAAG
AGTTTAATCATAAAAACAA -> GTTTAATCATAAAAACAAA
AGTTTCCCGTAGATACTTC -> GTTTCCCGTAGATACTTCC
ATAAAAACAAAATAGCCCC -> TAAAAACAAAATAGCCCCC
ATAAAGTGGCAAGGTGGTG -> TAAAGTGGCAAGGTGGTGA
ATAACGGGTGGTTTATCGG -> TAACGGGTGGTTTATCGGG
ATAATCACGTCATTATGCC -> TAATCACGTCATTATGCCC
ATAATCCTAGAAAGATGTA -> TAATCCTAGAAAGATGTAG
ATACACCGTGATCAGACCT -> TACACCGTGATCAGACCTG
ATACTATATCTAGGGAAGC -> TACTATATCTAGGGAAGCA
ATACTTCCTGATCGTACGA -> TACTTCCTGATCGTACGAT
ATAGAAGGACAGTCGTTCT -> TAGAAGGACAGTCGTTCTT
ATAGCATGACAGATGTAAG -> TAGCATGACAGATGTAAGT
ATAGCCCCCTGTGGATTAT -> TAGCCCCCTGTGGATTATT
ATAGGGAGACTTCCAGATG -> TAGGGAGACTTCCAGATGT
ATAGGTTGTAGAATTTTGG -> TAGGTTGTAGAATTTTGGA
ATATAATCCTAGAAAGATG -> TATAATCCTAGAAAGATGT
ATATATATCCCCGAATTCG -> TATATATCCCCGAATTCGC
ATATATCCCCGAATTCGCT -> TATATCCCCGAATTCGCTC
ATATCCCCGAATTCGCTCG -> TATCCCCGAATTCGCTCGA
ATATCGATTATCTTGGGTC -> TATCGATTATCTTGGGTCG
ATATCTAGGGAAGCAGCTT -> TATCTAGGGAAGCAGCTTT
ATATCTTAGCCGGGCACAA -> TATCTTAGCCGGGCACAAT
ATATTAGACCTATTCCCCT -> TATTAGACCTATTCCCCTT
ATCAACAATCCTCACCCGT -> TCAACAATCCTCACCCGTC
ATCAATGCGATGGACTTCG -> TCAATGCGATGGACTTCGA
ATCAATTCGGACCACTTAT -> TCAATTCGGACCACTTATA
ATCACAAGTTCGGCCTGGG -> TCACAAGTTCGGCCTGGGA
ATCACAATTTTTTACCCTT -> TCACAATTTTTTACCCTTG
ATCACATCCAACCGGCTAG -> TCACATCCAACCGGCTAGA
ATCACGGCCCACCGAACAA -> TCACGGCCCACCGAACAAC
ATCACGTCATTATGCCCCC -> TCACGTCATTATGCCCCCT
ATCAGAACGCCCTCAACCA -> TCAGAACGCCCTCAACCAT
ATCAGACCTGCTCCAAGTG -> TCAGACCTGCTCCAAGTGT
ATCAGAGAAGCTTAGCTGA -> TCAGAGAAGCTTAGCTGAG
ATCATAAAAACAAAATAGC -> TCATAAAAACAAAATAGCC
ATCATATATATCCCCGAAT -> TCATATATATCCCCGAATT
ATCATGCGTTACGTAATGC -> TCATGCGTTACGTAATGCA
ATCATTATGCCGGCTAGCT -> TCATTATGCCGGCTAGCTT
ATCCAACCGGCTAGATTAG -> TCCAACCGGCTAGATTAGG
ATCCCAGACTAGAGATGCA -> TCCCAGACTAGAGATGCAC
ATCCCCGAATTCGCTCGAT -> TCCCCGAATTCGCTCGATC
ATCCCTGTCTCGGACACAT -> TCCCTGTCTCGGACACATT
ATCCTAGAAAGATGTAGAC -> TCCTAGAAAGATGTAGACA
ATCCTCACCCGTCCAAAAA -> TCCTCACCCGTCCAAAAAC
ATCCTCAGGGTCAAGGCTC -> TCCTCAGGGTCAAGGCTCC
ATCCTGACACTCGAAAGAA -> TCCTGACACTCGAAAGAAC
ATCGACGGGGTATTGCCCT -> TCGACGGGGTATTGCCCTA
ATCGATTATCTTGGGTCGA -> TCGATTATCTTGGGTCGAC
ATCGCGGGTGACGCACCTC -> TCGCGGGTGACGCACCTCA
ATCGCTAATAGGGAGACTT -> TCGCTAATAGGGAGACTTC
ATCGCTACCTTTACTCCTA -> TCGCTACCTTTACTCCTAA
ATCGGGGATGTAAGGGGAT -> TCGGGGATGTAAGGGGATT
ATCGTAAGCGATTTCCACT -> TCGTAAGCGATTTCCACTG
ATCGTACGATTATCGCGGG -> TCGTACGATTATCGCGGGT
ATCTAGGGAAGCAGCTTTC -> TCTAGGGAAGCAGCTTTCG
ATCTATATCTTAGCCGGGC -> TCTATATCTTAGCCGGGCA
ATCTCCCTGTGGATTATTC -> TCTCCCTGTGGATTATTCC
ATCTGAGCGGCGGCCGTTG -> TCTGAGCGGCGGCCGTTGA
ATCTGCCTTCATTCGTCAA -> TCTGCCTTCATTCGTCAAG
ATCTGTTGGAGAGCTGTGT -> TCTGTTGGAGAGCTGTGTC
ATCTTAGCCGGGCACAATT -> TCTTAGCCGGGCACAATTA
ATCTTAGCTGAGCACTTGC -> TCTTAGCTGAGCACTTGCC
ATCTTCACAGTCACACGCA -> TCTTCACAGTCACACGCAG
ATCTTGGGTCGACATCAAC -> TCTTGGGTCGACATCAACA
ATGAAACGTACTGTTGACA -> TGAAACGTACTGTTGACAA
ATGACAGATGTAAGTGTTG -> TGACAGATGTAAGTGTTGG
ATGCAAAGCGTTTAATCCT -> TGCAAAGCGTTTAATCCTC
ATGCACTGTGACCCACTAG -> TGCACTGTGACCCACTAGA
ATGCCCCCTTGCATGTGTA -> TGCCCCCTTGCATGTGTAA
ATGCCGGCTAGCTTGCCAG -> TGCCGGCTAGCTTGCCAGG
ATGCGATGGACTTCGAATC -> TGCGATGGACTTCGAATCA
ATGCGTTACGTAATGCAAA -> TGCGTTACGTAATGCAAAG
ATGCTGTTGGTAAGTATCT -> TGCTGTTGGTAAGTATCTA
ATGGACTTCGAATCACAAT -> TGGACTTCGAATCACAATT
ATGGCCCTTAAGCTGGCTA -> TGGCCCTTAAGCTGGCTAT
ATGGCTGTACTTCAGTTCT -> TGGCTGTACTTCAGTTCTA
ATGGTGGTGGCTGCAAAGG -> TGGTGGTGGCTGCAAAGGC
ATGTAAGGGGATTTAGCCG -> TGTAAGGGGATTTAGCCGC
ATGTAAGTGTTGGTCGTCA -> TGTAAGTGTTGGTCGTCAA
ATGTAGACATGAAACGTAC -> TGTAGACATGAAACGTACT
ATGTAGGAAAGGCCCTTTC -> TGTAGGAAAGGCCCTTTCG
ATGTCTAGGACGCGCCGGC -> TGTCTAGGACGCGCCGGCT
ATGTCTTAGCTGAGCACTT -> TGTCTTAGCTGAGCACTTG
ATGTGCAACACAGGTGTAC -> TGTGCAACACAGGTGTACG
ATGTGTAAATCCCAGACTA -> TGTGTAAATCCCAGACTAG
ATGTTCATCCTGACACTCG -> TGTTCATCCTGACACTCGA
ATGTTGACGGTTGCAGAAT -> TGTTGACGGTTGCAGAATC
ATGTTGCCCCCCGGCCCGG -> TGTTGCCCCCCGGCCCGGC
ATTAAAAATTTCTACGTCC -> TTAAAAATTTCTACGTCCT
ATTAAGGGGTACACGGGTG -> TTAAGGGGTACACGGGTGG
ATTACATTCAGCGTGCCAA -> TTACATTCAGCGTGCCAAT
ATTACATTGTCTAAGGTTA -> TTACATTGTCTAAGGTTAA
ATTAGACCTATTCCCCTTA -> TTAGACCTATTCCCCTTAT
ATTAGATTCGGTCCTAGAA -> TTAGATTCGGTCCTAGAAC
ATTAGGGGACGGATTTCCT -> TTAGGGGACGGATTTCCTT
ATTATCGCGGGTGACGCAC -> TTATCGCGGGTGACGCACC
ATTATCTTGGGTCGACATC -> TTATCTTGGGTCGACATCA
ATTATGCCCCCTTGCATGT -> TTATGCCCCCTTGCATGTG
ATTATGCCGGCTAGCTTGC -> TTATGCCGGCTAGCTTGCC
ATTATTCCCCACTCGCCAT -> TTATTCCCCACTCGCCATG
ATTATTCCCCCATCAGAGA -> TTATTCCCCCATCAGAGAA
ATTATTCCCCGGTGTGAAG -> TTATTCCCCGGTGTGAAGA
ATTATTCCCCTACTCCCCA -> TTATTCCCCTACTCCCCAG
ATTCAAAGAACACCAAGGA -> TTCAAAGAACACCAAGGAG
ATTCAGCGTGCCAATAACG -> TTCAGCGTGCCAATAACGG
ATTCATCATATATATCCCC -> TTCATCATATATATCCCCG
ATTCCCCACTCGCCATGTC -> TTCCCCACTCGCCATGTCT
ATTCCCCCATCAGAGAAGC -> TTCCCCCATCAGAGAAGCT
ATTCCCCGGTGTGAAGATC -> TTCCCCGGTGTGAAGATCT
ATTCCCCTACTCCCCAGGC -> TTCCCCTACTCCCCAGGCT
ATTCCCCTTATGGTGGTGG -> TTCCCCTTATGGTGGTGGC
ATTCCTAGTATGTTGACGG -> TTCCTAGTATGTTGACGGT
ATTCGCTCGATCGTAAGCG -> TTCGCTCGATCGTAAGCGA
ATTCGGACCACTTATATCG -> TTCGGACCACTTATATCGA
ATTCGGCACCCTGGCACGG -> TTCGGCACCCTGGCACGGT
ATTCGGTCCTAGAACGTAT -> TTCGGTCCTAGAACGTATA
ATTCGTACGGCAGGGGTTG -> TTCGTACGGCAGGGGTTGA
ATTCGTCAAGCCCGACTTT -> TTCGTCAAGCCCGACTTTG
ATTCGTCCTTCCTATCAAT -> TTCGTCCTTCCTATCAATG
ATTCTGTAGCAAGTCTCGG -> TTCTGTAGCAAGTCTCGGG
ATTGAGGCTAGTTGGATGC -> TTGAGGCTAGTTGGATGCT
ATTGAGTCGCGCAGTGAAC -> TTGAGTCGCGCAGTGAACT
ATTGCCCTAGAAAAAATCT -> TTGCCCTAGAAAAAATCTC
ATTGGGCCTTTAAAACCAA -> TTGGGCCTTTAAAACCAAA
ATTGGGGGGCAAAGTTCAT -> TTGGGGGGCAAAGTTCATG
ATTGTCTAAGGTTAATTCC -> TTGTCTAAGGTTAATTCCT
ATTGTTTCGCTTTAGTCAA -> TTGTTTCGCTTTAGTCAAG
ATTTAGCCGCGACGAAGTT -> TTTAGCCGCGACGAAGTTT
ATTTCCACTGTGCGTAGAC -> TTTCCACTGTGCGTAGACG
ATTTCCTTTTGGTTATATT -> TTTCCTTTTGGTTATATTA
ATTTCTACGTCCTGTAGTC -> TTTCTACGTCCTGTAGTCT
ATTTGAAGACCTACAGACG -> TTTGAAGACCTACAGACGG
ATTTTGGAAACTTAGACAA -> TTTTGGAAACTTAGACAAA
ATTTTTGTCCGGGGGGTAT -> TTTTTGTCCGGGGGGTATA
ATTTTTTACCCTTGGGAGG -> TTTTTTACCCTTGGGAGGG
CAAAAACGGTAAGGCGAGA -> AAAAACGGTAAGGCGAGAG
CAAAACCTAGAGTTCGGCA -> AAAACCTAGAGTTCGGCAG
CAAAAGATTGAGGCTAGTT -> AAAAGATTGAGGCTAGTTG
CAAAATAGCCCCCTGTGGA -> AAAATAGCCCCCTGTGGAT
CAAACCGTGGCGAGCTCCT -> AAACCGTGGCGAGCTCCTG
CAAAGAACACCAAGGAGGT -> AAAGAACACCAAGGAGGTC
CAAAGCGTTTAATCCTCAG -> AAAGCGTTTAATCCTCAGG
CAAAGGCCTATCAGAACGC -> AAAGGCCTATCAGAACGCC
CAAAGTTCATGGCTGTACT -> AAAGTTCATGGCTGTACTT
CAACAATCCTCACCCGTCC -> AACAATCCTCACCCGTCCA
CAACACAGGTGTACGCTCA -> AACACAGGTGTACGCTCAT
CAACAGTAAAACCATGTTC -> AACAGTAAAACCATGTTCA
CAACCATTAAAAATTTCTA -> AACCATTAAAAATTTCTAC
CAACCGGAGGGCTCACGCC -> AACCGGAGGGCTCACGCCC
CAACCGGCTAGATTAGGGG -> AACCGGCTAGATTAGGGGA
CAACGGTCCTTTGGATTAC -> AACGGTCCTTTGGATTACA
CAAGACGAAATCCCTGTCT -> AAGACGAAATCCCTGTCTC
CAAGACGTGCATTTGAAGA -> AAGACGTGCATTTGAAGAC
CAAGAGCATTTTTGTCCGG -> AAGAGCATTTTTGTCCGGG
CAAGCCCGACTTTGTAATT -> AAGCCCGACTTTGTAATTG
CAAGGAGGTCGAGTAGTGT -> AAGGAGGTCGAGTAGTGTG
CAAGGCTCCATCTTCACAG -> AAGGCTCCATCTTCACAGT
CAAGGTGGTGATGTGCAAC -> AAGGTGGTGATGTGCAACA
CAAGTCTCGGGATGTAGGA -> AAGTCTCGGGATGTAGGAA
CAAGTGTCTGGCCAGAGGA -> AAGTGTCTGGCCAGAGGAG
CAAGTTCGGCCTGGGAGCA -> AAGTTCGGCCTGGGAGCAC
CAATAACGGGTGGTTTATC -> AATAACGGGTGGTTTATCG
CAATACACCGTGATCAGAC -> AATACACCGTGATCAGACC
CAATCAATTCGGACCACTT -> AATCAATTCGGACCACTTA
CAATCCTCACCCGTCCAAA -> AATCCTCACCCGTCCAAAA
CAATCGCTAATAGGGAGAC -> AATCGCTAATAGGGAGACT
CAATCGCTACCTTTACTCC -> AATCGCTACCTTTACTCCT
CAATGCGATGGACTTCGAA -> AATGCGATGGACTTCGAAT
CAATTACATTCAGCGTGCC -> AATTACATTCAGCGTGCCA
CAATTCGGACCACTTATAT -> AATTCGGACCACTTATATC
CAATTCGGCACCCTGGCAC -> AATTCGGCACCCTGGCACG
CAATTTTTTACCCTTGGGA -> AATTTTTTACCCTTGGGAG
CACAAGACGAAATCCCTGT -> ACAAGACGAAATCCCTGTC
CACAAGTTCGGCCTGGGAG -> ACAAGTTCGGCCTGGGAGC
CACAATTACATTCAGCGTG -> ACAATTACATTCAGCGTGC
CACAATTTTTTACCCTTGG -> ACAATTTTTTACCCTTGGG
CACACGCAGAATTAGATTC -> ACACGCAGAATTAGATTCG
CACAGCCAATACACCGTGA -> ACAGCCAATACACCGTGAT
CACAGGTGTACGCTCATTC -> ACAGGTGTACGCTCATTCA
CACAGTCACACGCAGAATT -> ACAGTCACACGCAGAATTA
CACAGTTTAATCATAAAAA -> ACAGTTTAATCATAAAAAC
CACATAGAAGGACAGTCGT -> ACATAGAAGGACAGTCGTT
CACATCCAACCGGCTAGAT -> ACATCCAACCGGCTAGATT
CACATTGAGTCGCGCAGTG -> ACATTGAGTCGCGCAGTGA
CACCAAGGAGGTCGAGTAG -> ACCAAGGAGGTCGAGTAGT
CACCAGGAGTGCGGTGGCA -> ACCAGGAGTGCGGTGGCAT
CACCCGTCCAAAAACGGTA -> ACCCGTCCAAAAACGGTAA
CACCCTGGCACGGTAACAC -> ACCCTGGCACGGTAACACG
CACCCTGTGGATTATTCCC -> ACCCTGTGGATTATTCCCC
CACCGAACAACCGGAGGGC -> ACCGAACAACCGGAGGGCT
CACCGTGATCAGACCTGCT -> ACCGTGATCAGACCTGCTC
CACCTCACAGCCAATACAC -> ACCTCACAGCCAATACACC
CACGCAGAATTAGATTCGG -> ACGCAGAATTAGATTCGGT
CACGCCCTGTGGATTATTC -> ACGCCCTGTGGATTATTCC
CACGGCCCACCGAACAACC -> ACGGCCCACCGAACAACCG
CACGGGTGGTGACTTGGGC -> ACGGGTGGTGACTTGGGCG
CACGGTAACACGTAGTAAA -> ACGGTAACACGTAGTAAAC
CACGTAGTAAACAACGGTC -> ACGTAGTAAACAACGGTCC
CACGTCATTATGCCCCCTT -> ACGTCATTATGCCCCCTTG
CACTAGAATTCTGTAGCAA -> ACTAGAATTCTGTAGCAAG
CACTCAGTAAAGCGCCCGC -> ACTCAGTAAAGCGCCCGCA
CACTCGAAAGAACGGATCA -> ACTCGAAAGAACGGATCAC
CACTCGCCATGTCTTAGCT -> ACTCGCCATGTCTTAGCTG
CACTCTTCAGACTCGTTCT -> ACTCTTCAGACTCGTTCTG
CACTGTGACCCACTAGAAT -> ACTGTGACCCACTAGAATT
CACTGTGCGTAGACGGACT -> ACTGTGCGTAGACGGACTT
CACTTATATCGATTATCTT -> ACTTATATCGATTATCTTG
CACTTGCCGCGGGAGGCAA -> ACTTGCCGCGGGAGGCAAA
CACTTGCCGCTCGTTACTA -> ACTTGCCGCTCGTTACTAC
CACTTGCCGGACCTCGGTC -> ACTTGCCGGACCTCGGTCC
CACTTGCCGTGCCGTTAGA -> ACTTGCCGTGCCGTTAGAA
CAGAACGCCCTCAACCATT -> AGAACGCCCTCAACCATTA
CAGAATCTGTTGGAGAGCT -> AGAATCTGTTGGAGAGCTG
CAGAATTAGATTCGGTCCT -> AGAATTAGATTCGGTCCTA
CAGACCTGCTCCAAGTGTC -> AGACCTGCTCCAAGTGTCT
CAGACGGCGTTGCACTCAG -> AGACGGCGTTGCACTCAGT
CAGACTAGAGATGCACTGT -> AGACTAGAGATGCACTGTG
CAGACTCGTTCTGCACATA -> AGACTCGTTCTGCACATAG
CAGAGAAGCTTAGCTGAGC -> AGAGAAGCTTAGCTGAGCA
CAGAGGAGTGGAGATATAA -> AGAGGAGTGGAGATATAAT
CAGATGGCCCTTAAGCTGG -> AGATGGCCCTTAAGCTGGC
CAGATGTAAGTGTTGGTCG -> AGATGTAAGTGTTGGTCGT
CAGATGTCTAGGACGCGCC -> AGATGTCTAGGACGCGCCG
CAGCCAATACACCGTGATC -> AGCCAATACACCGTGATCA
CAGCGTGCCAATAACGGGT -> AGCGTGCCAATAACGGGTG
CAGCTTTCGCGGCCCGTAC -> AGCTTTCGCGGCCCGTACG
CAGGAGTGCGGTGGCATTA -> AGGAGTGCGGTGGCATTAA
CAGGCGAACTCAGTCATTC -> AGGCGAACTCAGTCATTCA
CAGGCTTAGCTGAGCACTT -> AGGCTTAGCTGAGCACTTG
CAGGGATTGGGGGGCAAAG -> AGGGATTGGGGGGCAAAGT
CAGGGGTTGAATTCGTCCT -> AGGGGTTGAATTCGTCCTT
CAGGGTCAAGGCTCCATCT -> AGGGTCAAGGCTCCATCTT
CAGGTGTACGCTCATTCAA -> AGGTGTACGCTCATTCAAA
CAGTAAAACCATGTTCATC -> AGTAAAACCATGTTCATCC
CAGTAAAGCGCCCGCAATT -> AGTAAAGCGCCCGCAATTC
CAGTAAGAGACACCAGGAG -> AGTAAGAGACACCAGGAGT
CAGTCACACGCAGAATTAG -> AGTCACACGCAGAATTAGA
CAGTCATTCATCATATATA -> AGTCATTCATCATATATAT
CAGTCGTTCTTGGTTGCTT -> AGTCGTTCTTGGTTGCTTA
CAGTGAACTCACAGTTTAA -> AGTGAACTCACAGTTTAAT
CAGTTCTAGCCTTAAGGCT -> AGTTCTAGCCTTAAGGCTC
CAGTTTAATCATAAAAACA -> AGTTTAATCATAAAAACAA
CATAAAAACAAAATAGCCC -> ATAAAAACAAAATAGCCCC
CATAGAAGGACAGTCGTTC -> ATAGAAGGACAGTCGTTCT
CATAGCATGACAGATGTAA -> ATAGCATGACAGATGTAAG
CATATATATCCCCGAATTC -> ATATATATCCCCGAATTCG
CATCAACAATCCTCACCCG -> ATCAACAATCCTCACCCGT
CATCAGAGAAGCTTAGCTG -> ATCAGAGAAGCTTAGCTGA
CATCATATATATCCCCGAA -> ATCATATATATCCCCGAAT
CATCCAACCGGCTAGATTA -> ATCCAACCGGCTAGATTAG
CATCCTGACACTCGAAAGA -> ATCCTGACACTCGAAAGAA
CATCTGCCTTCATTCGTCA -> ATCTGCCTTCATTCGTCAA
CATCTTCACAGTCACACGC -> ATCTTCACAGTCACACGCA
CATGAAACGTACTGTTGAC -> ATGAAACGTACTGTTGACA
CATGACAGATGTAAGTGTT -> ATGACAGATGTAAGTGTTG
CATGCGTTACGTAATGCAA -> ATGCGTTACGTAATGCAAA
CATGGCTGTACTTCAGTTC -> ATGGCTGTACTTCAGTTCT
CATGTCTTAGCTGAGCACT -> ATGTCTTAGCTGAGCACTT
CATGTGTAAATCCCAGACT -> ATGTGTAAATCCCAGACTA
CATGTTCATCCTGACACTC -> ATGTTCATCCTGACACTCG
CATGTTGCCCCCCGGCCCG -> ATGTTGCCCCCCGGCCCGG
CATTAAAAATTTCTACGTC -> ATTAAAAATTTCTACGTCC
CATTAAGGGGTACACGGGT -> ATTAAGGGGTACACGGGTG
CATTATGCCCCCTTGCATG -> ATTATGCCCCCTTGCATGT
CATTATGCCGGCTAGCTTG -> ATTATGCCGGCTAGCTTGC
CATTCAAAGAACACCAAGG -> ATTCAAAGAACACCAAGGA
CATTCAGCGTGCCAATAAC -> ATTCAGCGTGCCAATAACG
CATTCATCATATATATCCC -> ATTCATCATATATATCCCC
CATTCGTCAAGCCCGACTT -> ATTCGTCAAGCCCGACTTT
CATTGAGTCGCGCAGTGAA -> ATTGAGTCGCGCAGTGAAC
CATTGTCTAAGGTTAATTC -> ATTGTCTAAGGTTAATTCC
CATTTGAAGACCTACAGAC -> ATTTGAAGACCTACAGACG
CATTTTTGTCCGGGGGGTA -> ATTTTTGTCCGGGGGGTAT
CCAAAAACGGTAAGGCGAG -> CAAAAACGGTAAGGCGAGA
CCAAACCGTGGCGAGCTCC -> CAAACCGTGGCGAGCTCCT
CCAACAGTAAAACCATGTT -> CAACAGTAAAACCATGTTC
CCAACCGGCTAGATTAGGG -> CAACCGGCTAGATTAGGGG
CCAAGGAGGTCGAGTAGTG -> CAAGGAGGTCGAGTAGTGT
CCAAGTGTCTGGCCAGAGG -> CAAGTGTCTGGCCAGAGGA
CCAATAACGGGTGGTTTAT -> CAATAACGGGTGGTTTATC
CCAATACACCGTGATCAGA -> CAATACACCGTGATCAGAC
CCAATCGCTACCTTTACTC -> CAATCGCTACCTTTACTCC
CCACCGAACAACCGGAGGG -> CACCGAACAACCGGAGGGC
CCACTAGAATTCTGTAGCA -> CACTAGAATTCTGTAGCAA
CCACTCGCCATGTCTTAGC -> CACTCGCCATGTCTTAGCT
CCACTGTGCGTAGACGGAC -> CACTGTGCGTAGACGGACT
CCACTTATATCGATTATCT -> CACTTATATCGATTATCTT
CCAGACTAGAGATGCACTG -> CAGACTAGAGATGCACTGT
CCAGAGGAGTGGAGATATA -> CAGAGGAGTGGAGATATAA
CCAGATGTCTAGGACGCGC -> CAGATGTCTAGGACGCGCC
CCAGGAGTGCGGTGGCATT -> CAGGAGTGCGGTGGCATTA
CCAGGCGAACTCAGTCATT -> CAGGCGAACTCAGTCATTC
CCAGGCTTAGCTGAGCACT -> CAGGCTTAGCTGAGCACTT
CCAGTAAGAGACACCAGGA -> CAGTAAGAGACACCAGGAG
CCATCAGAGAAGCTTAGCT -> CATCAGAGAAGCTTAGCTG
CCATCTTCACAGTCACACG -> CATCTTCACAGTCACACGC
CCATGTCTTAGCTGAGCAC -> CATGTCTTAGCTGAGCACT
CCATGTTCATCCTGACACT -> CATGTTCATCCTGACACTC
CCATTAAAAATTTCTACGT -> CATTAAAAATTTCTACGTC
CCCACCGAACAACCGGAGG -> CCACCGAACAACCGGAGGG
CCCACTAGAATTCTGTAGC -> CCACTAGAATTCTGTAGCA
CCCACTCGCCATGTCTTAG -> CCACTCGCCATGTCTTAGC
CCCAGACTAGAGATGCACT -> CCAGACTAGAGATGCACTG
CCCAGGCTTAGCTGAGCAC -> CCAGGCTTAGCTGAGCACT
CCCATCAGAGAAGCTTAGC -> CCATCAGAGAAGCTTAGCT
CCCCACTCGCCATGTCTTA -> CCCACTCGCCATGTCTTAG
CCCCAGGCTTAGCTGAGCA -> CCCAGGCTTAGCTGAGCAC
CCCCATCAGAGAAGCTTAG -> CCCATCAGAGAAGCTTAGC
CCCCCATCAGAGAAGCTTA -> CCCCATCAGAGAAGCTTAG
CCCCCCGGCCCGGCCAATC -> CCCCCGGCCCGGCCAATCG
CCCCCGGCCCGGCCAATCG -> CCCCGGCCCGGCCAATCGC
CCCCCTGTGGATTATTCCC -> CCCCTGTGGATTATTCCCC
CCCCCTTGCATGTGTAAAT -> CCCCTTGCATGTGTAAATC
CCCCGAATTCGCTCGATCG -> CCCGAATTCGCTCGATCGT
CCCCGGCCCGGCCAATCGC -> CCCGGCCCGGCCAATCGCT
CCCCGGTGTGAAGATCTTA -> CCCGGTGTGAAGATCTTAG
CCCCTACTCCCCAGGCTTA -> CCCTACTCCCCAGGCTTAG
CCCCTGTGGATTATTCCCC -> CCCTGTGGATTATTCCCCC
CCCCTTATGGTGGTGGCTG -> CCCTTATGGTGGTGGCTGC
CCCCTTGCATGTGTAAATC -> CCCTTGCATGTGTAAATCC
CCCGAAGGCGATCATGCGT -> CCGAAGGCGATCATGCGTT
CCCGAATTCGCTCGATCGT -> CCGAATTCGCTCGATCGTA
CCCGACTTTGTAATTGTTT -> CCGACTTTGTAATTGTTTC
CCCGCAATTCGGCACCCTG -> CCGCAATTCGGCACCCTGG
CCCGGCCAATCGCTACCTT -> CCGGCCAATCGCTACCTTT
CCCGGCCCGGCCAATCGCT -> CCGGCCCGGCCAATCGCTA
CCCGGTGTGAAGATCTTAG -> CCGGTGTGAAGATCTTAGC
CCCGTACGGGGACATGTTG -> CCGTACGGGGACATGTTGC
CCCGTAGATACTTCCTGAT -> CCGTAGATACTTCCTGATC
CCCGTCCAAAAACGGTAAG -> CCGTCCAAAAACGGTAAGG
CCCTACTCCCCAGGCTTAG -> CCTACTCCCCAGGCTTAGC
CCCTAGAAAAAATCTCCCT -> CCTAGAAAAAATCTCCCTG
CCCTCAACCATTAAAAATT -> CCTCAACCATTAAAAATTT
CCCTGGCACGGTAACACGT -> CCTGGCACGGTAACACGTA
CCCTGTCTCGGACACATTG -> CCTGTCTCGGACACATTGA
CCCTGTGGATTATTCCCCA -> CCTGTGGATTATTCCCCAC
CCCTGTGGATTATTCCCCC -> CCTGTGGATTATTCCCCCA
CCCTGTGGATTATTCCCCG -> CCTGTGGATTATTCCCCGG
CCCTGTGGATTATTCCCCT -> CCTGTGGATTATTCCCCTA
CCCTTAAGCTGGCTATTCG -> CCTTAAGCTGGCTATTCGT
CCCTTATGGTGGTGGCTGC -> CCTTATGGTGGTGGCTGCA
CCCTTGCATGTGTAAATCC -> CCTTGCATGTGTAAATCCC
CCCTTGGGAGGGGACCAGT -> CCTTGGGAGGGGACCAGTA
CCCTTTCGTATCTGAGCGG -> CCTTTCGTATCTGAGCGGC
CCGAACAACCGGAGGGCTC -> CGAACAACCGGAGGGCTCA
CCGAAGGCGATCATGCGTT -> CGAAGGCGATCATGCGTTA
CCGAATTCGCTCGATCGTA -> CGAATTCGCTCGATCGTAA
CCGACTTTGTAATTGTTTC -> CGACTTTGTAATTGTTTCG
CCGCAATTCGGCACCCTGG -> CGCAATTCGGCACCCTGGC
CCGCATAGCATGACAGATG -> CGCATAGCATGACAGATGT
CCGCGACGAAGTTTCCCGT -> CGCGACGAAGTTTCCCGTA
CCGCGGGAGGCAAAAGATT -> CGCGGGAGGCAAAAGATTG
CCGCTCGTTACTACCTGGT -> CGCTCGTTACTACCTGGTT
CCGGACCTCGGTCCTACTC -> CGGACCTCGGTCCTACTCC
CCGGAGGGCTCACGCCCTG -> CGGAGGGCTCACGCCCTGT
CCGGCCAATCGCTACCTTT -> CGGCCAATCGCTACCTTTA
CCGGCCCGGCCAATCGCTA -> CGGCCCGGCCAATCGCTAC
CCGGCTAGATTAGGGGACG -> CGGCTAGATTAGGGGACGG
CCGGCTAGCTTGCCAGGCG -> CGGCTAGCTTGCCAGGCGA
CCGGCTGACACAAGACGAA -> CGGCTGACACAAGACGAAA
CCGGGCACAATTACATTCA -> CGGGCACAATTACATTCAG
CCGGGGGGTATAATCACGT -> CGGGGGGTATAATCACGTC
CCGGTGTGAAGATCTTAGC -> CGGTGTGAAGATCTTAGCT
CCGTACGGGGACATGTTGC -> CGTACGGGGACATGTTGCC
CCGTAGATACTTCCTGATC -> CGTAGATACTTCCTGATCG
CCGTCCAAAAACGGTAAGG -> CGTCCAAAAACGGTAAGGC
CCGTGATCAGACCTGCTCC -> CGTGATCAGACCTGCTCCA
CCGTGCCGTTAGAACGACA -> CGTGCCGTTAGAACGACAA
CCGTGGCGAGCTCCTGCGC -> CGTGGCGAGCTCCTGCGCC
CCGTTAGAACGACAAGACG -> CGTTAGAACGACAAGACGT
CCGTTGATCGACGGGGTAT -> CGTTGATCGACGGGGTATT
CCTAACCTTAGCTGGCGTT -> CTAACCTTAGCTGGCGTTA
CCTACAGACGGCGTTGCAC -> CTACAGACGGCGTTGCACT
CCTACTCCCCAGGCTTAGC -> CTACTCCCCAGGCTTAGCT
CCTACTCCGCATAGCATGA -> CTACTCCGCATAGCATGAC
CCTAGAAAAAATCTCCCTG -> CTAGAAAAAATCTCCCTGT
CCTAGAAAGATGTAGACAT -> CTAGAAAGATGTAGACATG
CCTAGAACGTATAAAGTGG -> CTAGAACGTATAAAGTGGC
CCTAGAGTTCGGCAGATGG -> CTAGAGTTCGGCAGATGGC
CCTAGTATGTTGACGGTTG -> CTAGTATGTTGACGGTTGC
CCTATCAATGCGATGGACT -> CTATCAATGCGATGGACTT
CCTATCAGAACGCCCTCAA -> CTATCAGAACGCCCTCAAC
CCTATTCCCCTTATGGTGG -> CTATTCCCCTTATGGTGGT
CCTCAACCATTAAAAATTT -> CTCAACCATTAAAAATTTC
CCTCACAGCCAATACACCG -> CTCACAGCCAATACACCGT
CCTCACCCGTCCAAAAACG -> CTCACCCGTCCAAAAACGG
CCTCAGGGTCAAGGCTCCA -> CTCAGGGTCAAGGCTCCAT
CCTCGGTCCTACTCCGCAT -> CTCGGTCCTACTCCGCATA
CCTGACACTCGAAAGAACG -> CTGACACTCGAAAGAACGG
CCTGATCGTACGATTATCG -> CTGATCGTACGATTATCGC
CCTGCGCCCGAAGGCGATC -> CTGCGCCCGAAGGCGATCA
CCTGCTCCAAGTGTCTGGC -> CTGCTCCAAGTGTCTGGCC
CCTGGCACGGTAACACGTA -> CTGGCACGGTAACACGTAG
CCTGGGAGCACCCTGTGGA -> CTGGGAGCACCCTGTGGAT
CCTGGTTTTGGCTGGTGGT -> CTGGTTTTGGCTGGTGGTA
CCTGTAGTCTTCGTGTAAG -> CTGTAGTCTTCGTGTAAGC
CCTGTCTCGGACACATTGA -> CTGTCTCGGACACATTGAG
CCTGTGGATTATTCCCCAC -> CTGTGGATTATTCCCCACT
CCTGTGGATTATTCCCCCA -> CTGTGGATTATTCCCCCAT
CCTGTGGATTATTCCCCGG -> CTGTGGATTATTCCCCGGT
CCTGTGGATTATTCCCCTA -> CTGTGGATTATTCCCCTAC
CCTTAAGCTGGCTATTCGT -> CTTAAGCTGGCTATTCGTA
CCTTAAGGCTCGGTGAGCG -> CTTAAGGCTCGGTGAGCGG
CCTTAGCTGGCGTTAGAGC -> CTTAGCTGGCGTTAGAGCA
CCTTATGGTGGTGGCTGCA -> CTTATGGTGGTGGCTGCAA
CCTTCATTCGTCAAGCCCG -> CTTCATTCGTCAAGCCCGA
CCTTCCTATCAATGCGATG -> CTTCCTATCAATGCGATGG
CCTTGCATGTGTAAATCCC -> CTTGCATGTGTAAATCCCA
CCTTGGGAGGGGACCAGTA -> CTTGGGAGGGGACCAGTAA
CCTTTAAAACCAAACCGTG -> CTTTAAAACCAAACCGTGG
CCTTTACTCCTAACCTTAG -> CTTTACTCCTAACCTTAGC
CCTTTCGTATCTGAGCGGC -> CTTTCGTATCTGAGCGGCG
CCTTTGGATTACATTGTCT -> CTTTGGATTACATTGTCTA
CCTTTTGGTTATATTAGAC -> CTTTTGGTTATATTAGACC
CGAAAGAACGGATCACGGC -> GAAAGAACGGATCACGGCC
CGAAATCACATCCAACCGG -> GAAATCACATCCAACCGGC
CGAAATCCCTGTCTCGGAC -> GAAATCCCTGTCTCGGACA
CGAACAACCGGAGGGCTCA -> GAACAACCGGAGGGCTCAC
CGAACTCAGTCATTCATCA -> GAACTCAGTCATTCATCAT
CGAAGGCGATCATGCGTTA -> GAAGGCGATCATGCGTTAC
CGAAGTTTCCCGTAGATAC -> GAAGTTTCCCGTAGATACT
CGAATCACAATTTTTTACC -> GAATCACAATTTTTTACCC
CGAATTCGCTCGATCGTAA -> GAATTCGCTCGATCGTAAG
CGACAAGACGTGCATTTGA -> GACAAGACGTGCATTTGAA
CGACATCAACAATCCTCAC -> GACATCAACAATCCTCACC
CGACGAAGTTTCCCGTAGA -> GACGAAGTTTCCCGTAGAT
CGACGGGGTATTGCCCTAG -> GACGGGGTATTGCCCTAGA
CGACTTTGTAATTGTTTCG -> GACTTTGTAATTGTTTCGC
CGAGAGACACTCTTCAGAC -> GAGAGACACTCTTCAGACT
CGAGCTCCTGCGCCCGAAG -> GAGCTCCTGCGCCCGAAGG
CGAGTAGTGTGGATACTAT -> GAGTAGTGTGGATACTATA
CGATCATGCGTTACGTAAT -> GATCATGCGTTACGTAATG
CGATCGTAAGCGATTTCCA -> GATCGTAAGCGATTTCCAC
CGATGGACTTCGAATCACA -> GATGGACTTCGAATCACAA
CGATTATCGCGGGTGACGC -> GATTATCGCGGGTGACGCA
CGATTATCTTGGGTCGACA -> GATTATCTTGGGTCGACAT
CGATTTCCACTGTGCGTAG -> GATTTCCACTGTGCGTAGA
CGCAATTCGGCACCCTGGC -> GCAATTCGGCACCCTGGCA
CGCACCTCACAGCCAATAC -> GCACCTCACAGCCAATACA
CGCAGAATTAGATTCGGTC -> GCAGAATTAGATTCGGTCC
CGCAGTGAACTCACAGTTT -> GCAGTGAACTCACAGTTTA
CGCATAGCATGACAGATGT -> GCATAGCATGACAGATGTA
CGCCATGTCTTAGCTGAGC -> GCCATGTCTTAGCTGAGCA
CGCCCGAAGGCGATCATGC -> GCCCGAAGGCGATCATGCG
CGCCCGCAATTCGGCACCC -> GCCCGCAATTCGGCACCCT
CGCCCTCAACCATTAAAAA -> GCCCTCAACCATTAAAAAT
CGCCCTGTGGATTATTCCC -> GCCCTGTGGATTATTCCCC
CGCCGGCTGACACAAGACG -> GCCGGCTGACACAAGACGA
CGCGACGAAGTTTCCCGTA -> GCGACGAAGTTTCCCGTAG
CGCGCAGTGAACTCACAGT -> GCGCAGTGAACTCACAGTT
CGCGCCGGCTGACACAAGA -> GCGCCGGCTGACACAAGAC
CGCGGCCCGTACGGGGACA -> GCGGCCCGTACGGGGACAT
CGCGGGAGGCAAAAGATTG -> GCGGGAGGCAAAAGATTGA
CGCGGGTGACGCACCTCAC -> GCGGGTGACGCACCTCACA
CGCTAATAGGGAGACTTCC -> GCTAATAGGGAGACTTCCA
CGCTACCTTTACTCCTAAC -> GCTACCTTTACTCCTAACC
CGCTCATTCAAAGAACACC -> GCTCATTCAAAGAACACCA
CGCTCGATCGTAAGCGATT -> GCTCGATCGTAAGCGATTT
CGCTCGTTACTACCTGGTT -> GCTCGTTACTACCTGGTTT
CGCTTTAGTCAAGAGCATT -> GCTTTAGTCAAGAGCATTT
CGGACACATTGAGTCGCGC -> GGACACATTGAGTCGCGCA
CGGACCACTTATATCGATT -> GGACCACTTATATCGATTA
CGGACCTCGGTCCTACTCC -> GGACCTCGGTCCTACTCCG
CGGACTTATTGGGCCTTTA -> GGACTTATTGGGCCTTTAA
CGGAGGGCTCACGCCCTGT -> GGAGGGCTCACGCCCTGTG
CGGATCACGGCCCACCGAA -> GGATCACGGCCCACCGAAC
CGGATTTCCTTTTGGTTAT -> GGATTTCCTTTTGGTTATA
CGGCACCCTGGCACGGTAA -> GGCACCCTGGCACGGTAAC
CGGCAGATGGCCCTTAAGC -> GGCAGATGGCCCTTAAGCT
CGGCAGGGGTTGAATTCGT -> GGCAGGGGTTGAATTCGTC
CGGCCAATCGCTACCTTTA -> GGCCAATCGCTACCTTTAC
CGGCCCACCGAACAACCGG -> GGCCCACCGAACAACCGGA
CGGCCCGGCCAATCGCTAC -> GGCCCGGCCAATCGCTACC
CGGCCCGTACGGGGACATG -> GGCCCGTACGGGGACATGT
CGGCCGTTGATCGACGGGG -> GGCCGTTGATCGACGGGGT
CGGCCTGGGAGCACCCTGT -> GGCCTGGGAGCACCCTGTG
CGGCGGCCGTTGATCGACG -> GGCGGCCGTTGATCGACGG
CGGCGTTGCACTCAGTAAA -> GGCGTTGCACTCAGTAAAG
CGGCTAGATTAGGGGACGG -> GGCTAGATTAGGGGACGGA
CGGCTAGCTTGCCAGGCGA -> GGCTAGCTTGCCAGGCGAA
CGGCTGACACAAGACGAAA -> GGCTGACACAAGACGAAAT
CGGGAGGCAAAAGATTGAG -> GGGAGGCAAAAGATTGAGG
CGGGATGTAGGAAAGGCCC -> GGGATGTAGGAAAGGCCCT
CGGGCACAATTACATTCAG -> GGGCACAATTACATTCAGC
CGGGGACATGTTGCCCCCC -> GGGGACATGTTGCCCCCCG
CGGGGATGTAAGGGGATTT -> GGGGATGTAAGGGGATTTA
CGGGGGGTATAATCACGTC -> GGGGGGTATAATCACGTCA
CGGGGTATTGCCCTAGAAA -> GGGGTATTGCCCTAGAAAA
CGGGTGACGCACCTCACAG -> GGGTGACGCACCTCACAGC
CGGGTGGTGACTTGGGCGG -> GGGTGGTGACTTGGGCGGT
CGGGTGGTTTATCGGGGAT -> GGGTGGTTTATCGGGGATG
CGGTAACACGTAGTAAACA -> GGTAACACGTAGTAAACAA
CGGTAAGGCGAGAGACACT -> GGTAAGGCGAGAGACACTC
CGGTCCTACTCCGCATAGC -> GGTCCTACTCCGCATAGCA
CGGTCCTAGAACGTATAAA -> GGTCCTAGAACGTATAAAG
CGGTCCTTTGGATTACATT -> GGTCCTTTGGATTACATTG
CGGTGAGCGGTTATCACAA -> GGTGAGCGGTTATCACAAG
CGGTGCGTAGAGTTGGAGT -> GGTGCGTAGAGTTGGAGTG
CGGTGGCATTAAGGGGTAC -> GGTGGCATTAAGGGGTACA
CGGTGTGAAGATCTTAGCT -> GGTGTGAAGATCTTAGCTG
CGGTTATCACAAGTTCGGC -> GGTTATCACAAGTTCGGCC
CGGTTGCAGAATCTGTTGG -> GGTTGCAGAATCTGTTGGA
CGTAAGCGATTTCCACTGT -> GTAAGCGATTTCCACTGTG
CGTAATGCAAAGCGTTTAA -> GTAATGCAAAGCGTTTAAT
CGTACGATTATCGCGGGTG -> GTACGATTATCGCGGGTGA
CGTACGGCAGGGGTTGAAT -> GTACGGCAGGGGTTGAATT
CGTACGGGGACATGTTGCC -> GTACGGGGACATGTTGCCC
CGTACTGTTGACAATCGCT -> GTACTGTTGACAATCGCTA
CGTAGACGGACTTATTGGG -> GTAGACGGACTTATTGGGC
CGTAGAGTTGGAGTGTACG -> GTAGAGTTGGAGTGTACGC
CGTAGATACTTCCTGATCG -> GTAGATACTTCCTGATCGT
CGTAGTAAACAACGGTCCT -> GTAGTAAACAACGGTCCTT
CGTATAAAGTGGCAAGGTG -> GTATAAAGTGGCAAGGTGG
CGTATCTGAGCGGCGGCCG -> GTATCTGAGCGGCGGCCGT
CGTCAAGCCCGACTTTGTA -> GTCAAGCCCGACTTTGTAA
CGTCAATCAATTCGGACCA -> GTCAATCAATTCGGACCAC
CGTCATTATGCCCCCTTGC -> GTCATTATGCCCCCTTGCA
CGTCCAAAAACGGTAAGGC -> GTCCAAAAACGGTAAGGCG
CGTCCTGTAGTCTTCGTGT -> GTCCTGTAGTCTTCGTGTA
CGTCCTTCCTATCAATGCG -> GTCCTTCCTATCAATGCGA
CGTGATCAGACCTGCTCCA -> GTGATCAGACCTGCTCCAA
CGTGCATTTGAAGACCTAC -> GTGCATTTGAAGACCTACA
CGTGCCAATAACGGGTGGT -> GTGCCAATAACGGGTGGTT
CGTGCCGTTAGAACGACAA -> GTGCCGTTAGAACGACAAG
CGTGGCGAGCTCCTGCGCC -> GTGGCGAGCTCCTGCGCCC
CGTGTAAGCCAACAGTAAA -> GTGTAAGCCAACAGTAAAA
CGTTACGTAATGCAAAGCG -> GTTACGTAATGCAAAGCGT
CGTTACTACCTGGTTTTGG -> GTTACTACCTGGTTTTGGC
CGTTAGAACGACAAGACGT -> GTTAGAACGACAAGACGTG
CGTTAGAGCATCTGCCTTC -> GTTAGAGCATCTGCCTTCA
CGTTCTGCACATAGAAGGA -> GTTCTGCACATAGAAGGAC
CGTTCTTGGTTGCTTAGGG -> GTTCTTGGTTGCTTAGGGG
CGTTGATCGACGGGGTATT -> GTTGATCGACGGGGTATTG
CGTTGCACTCAGTAAAGCG -> GTTGCACTCAGTAAAGCGC
CGTTTAATCCTCAGGGTCA -> GTTTAATCCTCAGGGTCAA
CTAACCTTAGCTGGCGTTA -> TAACCTTAGCTGGCGTTAG
CTAAGAATAGGTTGTAGAA -> TAAGAATAGGTTGTAGAAT
CTAAGGTTAATTCCTAGTA -> TAAGGTTAATTCCTAGTAT
CTAAGTGTGCTAAGAATAG -> TAAGTGTGCTAAGAATAGG
CTAATAGGGAGACTTCCAG -> TAATAGGGAGACTTCCAGA
CTACAGACGGCGTTGCACT -> TACAGACGGCGTTGCACTC
CTACCTGGTTTTGGCTGGT -> TACCTGGTTTTGGCTGGTG
CTACCTTTACTCCTAACCT -> TACCTTTACTCCTAACCTT
CTACGTCCTGTAGTCTTCG -> TACGTCCTGTAGTCTTCGT
CTACTCCCCAGGCTTAGCT -> TACTCCCCAGGCTTAGCTG
CTACTCCGCATAGCATGAC -> TACTCCGCATAGCATGACA
CTAGAAAAAATCTCCCTGT -> TAGAAAAAATCTCCCTGTG
CTAGAAAGATGTAGACATG -> TAGAAAGATGTAGACATGA
CTAGAACGTATAAAGTGGC -> TAGAACGTATAAAGTGGCA
CTAGAATTCTGTAGCAAGT -> TAGAATTCTGTAGCAAGTC
CTAGAGATGCACTGTGACC -> TAGAGATGCACTGTGACCC
CTAGAGTTCGGCAGATGGC -> TAGAGTTCGGCAGATGGCC
CTAGATTAGGGGACGGATT -> TAGATTAGGGGACGGATTT
CTAGCCTTAAGGCTCGGTG -> TAGCCTTAAGGCTCGGTGA
CTAGCTTGCCAGGCGAACT -> TAGCTTGCCAGGCGAACTC
CTAGGACGCGCCGGCTGAC -> TAGGACGCGCCGGCTGACA
CTAGGGAAGCAGCTTTCGC -> TAGGGAAGCAGCTTTCGCG
CTAGTATGTTGACGGTTGC -> TAGTATGTTGACGGTTGCA
CTAGTTGGATGCTGTTGGT -> TAGTTGGATGCTGTTGGTA
CTATATCTAGGGAAGCAGC -> TATATCTAGGGAAGCAGCT
CTATATCTTAGCCGGGCAC -> TATATCTTAGCCGGGCACA
CTATCAATGCGATGGACTT -> TATCAATGCGATGGACTTC
CTATCAGAACGCCCTCAAC -> TATCAGAACGCCCTCAACC
CTATTCCCCTTATGGTGGT -> TATTCCCCTTATGGTGGTG
CTATTCGTACGGCAGGGGT -> TATTCGTACGGCAGGGGTT
CTCAACCATTAAAAATTTC -> TCAACCATTAAAAATTTCT
CTCACAGCCAATACACCGT -> TCACAGCCAATACACCGTG
CTCACAGTTTAATCATAAA -> TCACAGTTTAATCATAAAA
CTCACCCGTCCAAAAACGG -> TCACCCGTCCAAAAACGGT
CTCACGCCCTGTGGATTAT -> TCACGCCCTGTGGATTATT
CTCAGGGTCAAGGCTCCAT -> TCAGGGTCAAGGCTCCATC
CTCAGTAAAGCGCCCGCAA -> TCAGTAAAGCGCCCGCAAT
CTCAGTCATTCATCATATA -> TCAGTCATTCATCATATAT
CTCATTCAAAGAACACCAA -> TCATTCAAAGAACACCAAG
CTCCAAGTGTCTGGCCAGA -> TCCAAGTGTCTGGCCAGAG
CTCCATCTTCACAGTCACA -> TCCATCTTCACAGTCACAC
CTCCCCAGGCTTAGCTGAG -> TCCCCAGGCTTAGCTGAGC
CTCCCTGTGGATTATTCCC -> TCCCTGTGGATTATTCCCC
CTCCGCATAGCATGACAGA -> TCCGCATAGCATGACAGAT
CTCCTAACCTTAGCTGGCG -> TCCTAACCTTAGCTGGCGT
CTCCTGCGCCCGAAGGCGA -> TCCTGCGCCCGAAGGCGAT
CTCGAAAGAACGGATCACG -> TCGAAAGAACGGATCACGG
CTCGATCGTAAGCGATTTC -> TCGATCGTAAGCGATTTCC
CTCGCCATGTCTTAGCTGA -> TCGCCATGTCTTAGCTGAG
CTCGGACACATTGAGTCGC -> TCGGACACATTGAGTCGCG
CTCGGGATGTAGGAAAGGC -> TCGGGATGTAGGAAAGGCC
CTCGGTCCTACTCCGCATA -> TCGGTCCTACTCCGCATAG
CTCGGTGAGCGGTTATCAC -> TCGGTGAGCGGTTATCACA
CTCGTTACTACCTGGTTTT -> TCGTTACTACCTGGTTTTG
CTCGTTCTGCACATAGAAG -> TCGTTCTGCACATAGAAGG
CTCTTCAGACTCGTTCTGC -> TCTTCAGACTCGTTCTGCA
CTGACACAAGACGAAATCC -> TGACACAAGACGAAATCCC
CTGACACTCGAAAGAACGG -> TGACACTCGAAAGAACGGA
CTGAGCACTTGCCGCGGGA -> TGAGCACTTGCCGCGGGAG
CTGAGCACTTGCCGCTCGT -> TGAGCACTTGCCGCTCGTT
CTGAGCACTTGCCGGACCT -> TGAGCACTTGCCGGACCTC
CTGAGCACTTGCCGTGCCG -> TGAGCACTTGCCGTGCCGT
CTGAGCGGCGGCCGTTGAT -> TGAGCGGCGGCCGTTGATC
CTGATCGTACGATTATCGC -> TGATCGTACGATTATCGCG
CTGCAAAGGCCTATCAGAA -> TGCAAAGGCCTATCAGAAC
CTGCACATAGAAGGACAGT -> TGCACATAGAAGGACAGTC
CTGCCTTCATTCGTCAAGC -> TGCCTTCATTCGTCAAGCC
CTGCGCCCGAAGGCGATCA -> TGCGCCCGAAGGCGATCAT
CTGCTCCAAGTGTCTGGCC -> TGCTCCAAGTGTCTGGCCA
CTGGCACGGTAACACGTAG -> TGGCACGGTAACACGTAGT
CTGGCCAGAGGAGTGGAGA -> TGGCCAGAGGAGTGGAGAT
CTGGCGTTAGAGCATCTGC -> TGGCGTTAGAGCATCTGCC
CTGGCTATTCGTACGGCAG -> TGGCTATTCGTACGGCAGG
CTGGGAGCACCCTGTGGAT -> TGGGAGCACCCTGTGGATT
CTGGTGGTATCATTATGCC -> TGGTGGTATCATTATGCCG
CTGGTTTTGGCTGGTGGTA -> TGGTTTTGGCTGGTGGTAT
CTGTACTTCAGTTCTAGCC -> TGTACTTCAGTTCTAGCCT
CTGTAGCAAGTCTCGGGAT -> TGTAGCAAGTCTCGGGATG
CTGTAGTCTTCGTGTAAGC -> TGTAGTCTTCGTGTAAGCC
CTGTCTCGGACACATTGAG -> TGTCTCGGACACATTGAGT
CTGTGACCCACTAGAATTC -> TGTGACCCACTAGAATTCT
CTGTGCGTAGACGGACTTA -> TGTGCGTAGACGGACTTAT
CTGTGGATTATTCCCCACT -> TGTGGATTATTCCCCACTC
CTGTGGATTATTCCCCCAT -> TGTGGATTATTCCCCCATC
CTGTGGATTATTCCCCGGT -> TGTGGATTATTCCCCGGTG
CTGTGGATTATTCCCCTAC -> TGTGGATTATTCCCCTACT
CTGTGTCAGGGATTGGGGG -> TGTGTCAGGGATTGGGGGG
CTGTTGACAATCGCTAATA -> TGTTGACAATCGCTAATAG
CTGTTGGAGAGCTGTGTCA -> TGTTGGAGAGCTGTGTCAG
CTGTTGGTAAGTATCTATA -> TGTTGGTAAGTATCTATAT
CTTAAGCTGGCTATTCGTA -> TTAAGCTGGCTATTCGTAC
CTTAAGGCTCGGTGAGCGG -> TTAAGGCTCGGTGAGCGGT
CTTAGACAAAACCTAGAGT -> TTAGACAAAACCTAGAGTT
CTTAGCCGGGCACAATTAC -> TTAGCCGGGCACAATTACA
CTTAGCTGAGCACTTGCCG -> TTAGCTGAGCACTTGCCGC,TTAGCTGAGCACTTGCCGT,TTAGCTGAGCACTTGCCGC,TTAGCTGAGCACTTGCCGG
CTTAGCTGGCGTTAGAGCA -> TTAGCTGGCGTTAGAGCAT
CTTAGGGGTCTAAGTGTGC -> TTAGGGGTCTAAGTGTGCT
CTTATATCGATTATCTTGG -> TTATATCGATTATCTTGGG
CTTATGGTGGTGGCTGCAA -> TTATGGTGGTGGCTGCAAA
CTTATTGGGCCTTTAAAAC -> TTATTGGGCCTTTAAAACC
CTTCACAGTCACACGCAGA -> TTCACAGTCACACGCAGAA
CTTCAGACTCGTTCTGCAC -> TTCAGACTCGTTCTGCACA
CTTCAGTTCTAGCCTTAAG -> TTCAGTTCTAGCCTTAAGG
CTTCATTCGTCAAGCCCGA -> TTCATTCGTCAAGCCCGAC
CTTCCAGATGTCTAGGACG -> TTCCAGATGTCTAGGACGC
CTTCCTATCAATGCGATGG -> TTCCTATCAATGCGATGGA
CTTCCTGATCGTACGATTA -> TTCCTGATCGTACGATTAT
CTTCGAATCACAATTTTTT -> TTCGAATCACAATTTTTTA
CTTCGTGTAAGCCAACAGT -> TTCGTGTAAGCCAACAGTA
CTTGCATGTGTAAATCCCA -> TTGCATGTGTAAATCCCAG
CTTGCCAGGCGAACTCAGT -> TTGCCAGGCGAACTCAGTC
CTTGCCGCGGGAGGCAAAA -> TTGCCGCGGGAGGCAAAAG
CTTGCCGCTCGTTACTACC -> TTGCCGCTCGTTACTACCT
CTTGCCGGACCTCGGTCCT -> TTGCCGGACCTCGGTCCTA
CTTGCCGTGCCGTTAGAAC -> TTGCCGTGCCGTTAGAACG
CTTGGGAGGGGACCAGTAA -> TTGGGAGGGGACCAGTAAG
CTTGGGCGGTGCGTAGAGT -> TTGGGCGGTGCGTAGAGTT
CTTGGGTCGACATCAACAA -> TTGGGTCGACATCAACAAT
CTTGGTTGCTTAGGGGTCT -> TTGGTTGCTTAGGGGTCTA
CTTTAAAACCAAACCGTGG -> TTTAAAACCAAACCGTGGC
CTTTACTCCTAACCTTAGC -> TTTACTCCTAACCTTAGCT
CTTTAGTCAAGAGCATTTT -> TTTAGTCAAGAGCATTTTT
CTTTCGCGGCCCGTACGGG -> TTTCGCGGCCCGTACGGGG
CTTTCGTATCTGAGCGGCG -> TTTCGTATCTGAGCGGCGG
CTTTGGATTACATTGTCTA -> TTTGGATTACATTGTCTAA
CTTTGTAATTGTTTCGCTT -> TTTGTAATTGTTTCGCTTT
CTTTTGGTTATATTAGACC -> TTTTGGTTATATTAGACCT
GAAAAAATCTCCCTGTGGA -> AAAAAATCTCCCTGTGGAT
GAAACGTACTGTTGACAAT -> AAACGTACTGTTGACAATC
GAAACTTAGACAAAACCTA -> AAACTTAGACAAAACCTAG
GAAAGAACGGATCACGGCC -> AAAGAACGGATCACGGCCC
GAAAGATGTAGACATGAAA -> AAAGATGTAGACATGAAAC
GAAAGGCCCTTTCGTATCT -> AAAGGCCCTTTCGTATCTG
GAAATCACATCCAACCGGC -> AAATCACATCCAACCGGCT
GAAATCCCTGTCTCGGACA -> AAATCCCTGTCTCGGACAC
GAACAACCGGAGGGCTCAC -> AACAACCGGAGGGCTCACG
GAACACCAAGGAGGTCGAG -> AACACCAAGGAGGTCGAGT
GAACGACAAGACGTGCATT -> AACGACAAGACGTGCATTT
GAACGCCCTCAACCATTAA -> AACGCCCTCAACCATTAAA
GAACGGATCACGGCCCACC -> AACGGATCACGGCCCACCG
GAACGTATAAAGTGGCAAG -> AACGTATAAAGTGGCAAGG
GAACTCACAGTTTAATCAT -> AACTCACAGTTTAATCATA
GAACTCAGTCATTCATCAT -> AACTCAGTCATTCATCATA
GAAGACCTACAGACGGCGT -> AAGACCTACAGACGGCGTT
GAAGATCTTAGCTGAGCAC -> AAGATCTTAGCTGAGCACT
GAAGCAGCTTTCGCGGCCC -> AAGCAGCTTTCGCGGCCCG
GAAGCTTAGCTGAGCACTT -> AAGCTTAGCTGAGCACTTG
GAAGGACAGTCGTTCTTGG -> AAGGACAGTCGTTCTTGGT
GAAGGCGATCATGCGTTAC -> AAGGCGATCATGCGTTACG
GAAGTTTCCCGTAGATACT -> AAGTTTCCCGTAGATACTT
GAATAGGTTGTAGAATTTT -> AATAGGTTGTAGAATTTTG
GAATCACAATTTTTTACCC -> AATCACAATTTTTTACCCT
GAATCTGTTGGAGAGCTGT -> AATCTGTTGGAGAGCTGTG
GAATTAGATTCGGTCCTAG -> AATTAGATTCGGTCCTAGA
GAATTCGCTCGATCGTAAG -> AATTCGCTCGATCGTAAGC
GAATTCGTCCTTCCTATCA -> AATTCGTCCTTCCTATCAA
GAATTCTGTAGCAAGTCTC -> AATTCTGTAGCAAGTCTCG
GAATTTTGGAAACTTAGAC -> AATTTTGGAAACTTAGACA
GACAAAACCTAGAGTTCGG -> ACAAAACCTAGAGTTCGGC
GACAAGACGTGCATTTGAA -> ACAAGACGTGCATTTGAAG
GACAATCGCTAATAGGGAG -> ACAATCGCTAATAGGGAGA
GACACAAGACGAAATCCCT -> ACACAAGACGAAATCCCTG
GACACATTGAGTCGCGCAG -> ACACATTGAGTCGCGCAGT
GACACCAGGAGTGCGGTGG -> ACACCAGGAGTGCGGTGGC
GACACTCGAAAGAACGGAT -> ACACTCGAAAGAACGGATC
GACACTCTTCAGACTCGTT -> ACACTCTTCAGACTCGTTC
GACAGATGTAAGTGTTGGT -> ACAGATGTAAGTGTTGGTC
GACAGTCGTTCTTGGTTGC -> ACAGTCGTTCTTGGTTGCT
GACATCAACAATCCTCACC -> ACATCAACAATCCTCACCC
GACATGAAACGTACTGTTG -> ACATGAAACGTACTGTTGA
GACATGTTGCCCCCCGGCC -> ACATGTTGCCCCCCGGCCC
GACCACTTATATCGATTAT -> ACCACTTATATCGATTATC
GACCAGTAAGAGACACCAG -> ACCAGTAAGAGACACCAGG
GACCCACTAGAATTCTGTA -> ACCCACTAGAATTCTGTAG
GACCTACAGACGGCGTTGC -> ACCTACAGACGGCGTTGCA
GACCTATTCCCCTTATGGT -> ACCTATTCCCCTTATGGTG
GACCTCGGTCCTACTCCGC -> ACCTCGGTCCTACTCCGCA
GACCTGCTCCAAGTGTCTG -> ACCTGCTCCAAGTGTCTGG
GACGAAATCCCTGTCTCGG -> ACGAAATCCCTGTCTCGGA
GACGAAGTTTCCCGTAGAT -> ACGAAGTTTCCCGTAGATA
GACGCACCTCACAGCCAAT -> ACGCACCTCACAGCCAATA
GACGCGCCGGCTGACACAA -> ACGCGCCGGCTGACACAAG
GACGGACTTATTGGGCCTT -> ACGGACTTATTGGGCCTTT
GACGGATTTCCTTTTGGTT -> ACGGATTTCCTTTTGGTTA
GACGGCGTTGCACTCAGTA -> ACGGCGTTGCACTCAGTAA
GACGGGGTATTGCCCTAGA -> ACGGGGTATTGCCCTAGAA
GACGGTTGCAGAATCTGTT -> ACGGTTGCAGAATCTGTTG
GACGTGCATTTGAAGACCT -> ACGTGCATTTGAAGACCTA
GACTAGAGATGCACTGTGA -> ACTAGAGATGCACTGTGAC
GACTCGTTCTGCACATAGA -> ACTCGTTCTGCACATAGAA
GACTTATTGGGCCTTTAAA -> ACTTATTGGGCCTTTAAAA
GACTTCCAGATGTCTAGGA -> ACTTCCAGATGTCTAGGAC
GACTTCGAATCACAATTTT -> ACTTCGAATCACAATTTTT
GACTTGGGCGGTGCGTAGA -> ACTTGGGCGGTGCGTAGAG
GACTTTGTAATTGTTTCGC -> ACTTTGTAATTGTTTCGCT
GAGAAGCTTAGCTGAGCAC -> AGAAGCTTAGCTGAGCACT
GAGACACCAGGAGTGCGGT -> AGACACCAGGAGTGCGGTG
GAGACACTCTTCAGACTCG -> AGACACTCTTCAGACTCGT
GAGACTTCCAGATGTCTAG -> AGACTTCCAGATGTCTAGG
GAGAGACACTCTTCAGACT -> AGAGACACTCTTCAGACTC
GAGAGCTGTGTCAGGGATT -> AGAGCTGTGTCAGGGATTG
GAGATATAATCCTAGAAAG -> AGATATAATCCTAGAAAGA
GAGATGCACTGTGACCCAC -> AGATGCACTGTGACCCACT
GAGCACCCTGTGGATTATT -> AGCACCCTGTGGATTATTC
GAGCACTTGCCGCGGGAGG -> AGCACTTGCCGCGGGAGGC
GAGCACTTGCCGCTCGTTA -> AGCACTTGCCGCTCGTTAC
GAGCACTTGCCGGACCTCG -> AGCACTTGCCGGACCTCGG
GAGCACTTGCCGTGCCGTT -> AGCACTTGCCGTGCCGTTA
GAGCATCTGCCTTCATTCG -> AGCATCTGCCTTCATTCGT
GAGCATTTTTGTCCGGGGG -> AGCATTTTTGTCCGGGGGG
GAGCGGCGGCCGTTGATCG -> AGCGGCGGCCGTTGATCGA
GAGCGGTTATCACAAGTTC -> AGCGGTTATCACAAGTTCG
GAGCTCCTGCGCCCGAAGG -> AGCTCCTGCGCCCGAAGGC
GAGCTGTGTCAGGGATTGG -> AGCTGTGTCAGGGATTGGG
GAGGAGTGGAGATATAATC -> AGGAGTGGAGATATAATCC
GAGGCAAAAGATTGAGGCT -> AGGCAAAAGATTGAGGCTA
GAGGCTAGTTGGATGCTGT -> AGGCTAGTTGGATGCTGTT
GAGGGCTCACGCCCTGTGG -> AGGGCTCACGCCCTGTGGA
GAGGGGACCAGTAAGAGAC -> AGGGGACCAGTAAGAGACA
GAGGTCGAGTAGTGTGGAT -> AGGTCGAGTAGTGTGGATA
GAGTAGTGTGGATACTATA -> AGTAGTGTGGATACTATAT
GAGTCGCGCAGTGAACTCA -> AGTCGCGCAGTGAACTCAC
GAGTGCGGTGGCATTAAGG -> AGTGCGGTGGCATTAAGGG
GAGTGGAGATATAATCCTA -> AGTGGAGATATAATCCTAG
GAGTTCGGCAGATGGCCCT -> AGTTCGGCAGATGGCCCTT
GATACTATATCTAGGGAAG -> ATACTATATCTAGGGAAGC
GATACTTCCTGATCGTACG -> ATACTTCCTGATCGTACGA
GATATAATCCTAGAAAGAT -> ATATAATCCTAGAAAGATG
GATCACGGCCCACCGAACA -> ATCACGGCCCACCGAACAA
GATCAGACCTGCTCCAAGT -> ATCAGACCTGCTCCAAGTG
GATCATGCGTTACGTAATG -> ATCATGCGTTACGTAATGC
GATCGACGGGGTATTGCCC -> ATCGACGGGGTATTGCCCT
GATCGTAAGCGATTTCCAC -> ATCGTAAGCGATTTCCACT
GATCGTACGATTATCGCGG -> ATCGTACGATTATCGCGGG
GATCTTAGCTGAGCACTTG -> ATCTTAGCTGAGCACTTGC
GATGCACTGTGACCCACTA -> ATGCACTGTGACCCACTAG
GATGCTGTTGGTAAGTATC -> ATGCTGTTGGTAAGTATCT
GATGGACTTCGAATCACAA -> ATGGACTTCGAATCACAAT
GATGGCCCTTAAGCTGGCT -> ATGGCCCTTAAGCTGGCTA
GATGTAAGGGGATTTAGCC -> ATGTAAGGGGATTTAGCCG
GATGTAAGTGTTGGTCGTC -> ATGTAAGTGTTGGTCGTCA
GATGTAGACATGAAACGTA -> ATGTAGACATGAAACGTAC
GATGTAGGAAAGGCCCTTT -> ATGTAGGAAAGGCCCTTTC
GATGTCTAGGACGCGCCGG -> ATGTCTAGGACGCGCCGGC
GATGTGCAACACAGGTGTA -> ATGTGCAACACAGGTGTAC
GATTACATTGTCTAAGGTT -> ATTACATTGTCTAAGGTTA
GATTAGGGGACGGATTTCC -> ATTAGGGGACGGATTTCCT
GATTATCGCGGGTGACGCA -> ATTATCGCGGGTGACGCAC
GATTATCTTGGGTCGACAT -> ATTATCTTGGGTCGACATC
GATTATTCCCCACTCGCCA -> ATTATTCCCCACTCGCCAT
GATTATTCCCCCATCAGAG -> ATTATTCCCCCATCAGAGA
GATTATTCCCCGGTGTGAA -> ATTATTCCCCGGTGTGAAG
GATTATTCCCCTACTCCCC -> ATTATTCCCCTACTCCCCA
GATTCGGTCCTAGAACGTA -> ATTCGGTCCTAGAACGTAT
GATTGAGGCTAGTTGGATG -> ATTGAGGCTAGTTGGATGC
GATTGGGGGGCAAAGTTCA -> ATTGGGGGGCAAAGTTCAT
GATTTAGCCGCGACGAAGT -> ATTTAGCCGCGACGAAGTT
GATTTCCACTGTGCGTAGA -> ATTTCCACTGTGCGTAGAC
GATTTCCTTTTGGTTATAT -> ATTTCCTTTTGGTTATATT
GCAAAAGATTGAGGCTAGT -> CAAAAGATTGAGGCTAGTT
GCAAAGCGTTTAATCCTCA -> CAAAGCGTTTAATCCTCAG
GCAAAGGCCTATCAGAACG -> CAAAGGCCTATCAGAACGC
GCAAAGTTCATGGCTGTAC -> CAAAGTTCATGGCTGTACT
GCAACACAGGTGTACGCTC -> CAACACAGGTGTACGCTCA
GCAAGGTGGTGATGTGCAA -> CAAGGTGGTGATGTGCAAC
GCAAGTCTCGGGATGTAGG -> CAAGTCTCGGGATGTAGGA
GCAATTCGGCACCCTGGCA -> CAATTCGGCACCCTGGCAC
GCACAATTACATTCAGCGT -> CACAATTACATTCAGCGTG
GCACATAGAAGGACAGTCG -> CACATAGAAGGACAGTCGT
GCACCCTGGCACGGTAACA -> CACCCTGGCACGGTAACAC
GCACCCTGTGGATTATTCC -> CACCCTGTGGATTATTCCC
GCACCTCACAGCCAATACA -> CACCTCACAGCCAATACAC
GCACGGTAACACGTAGTAA -> CACGGTAACACGTAGTAAA
GCACTCAGTAAAGCGCCCG -> CACTCAGTAAAGCGCCCGC
GCACTGTGACCCACTAGAA -> CACTGTGACCCACTAGAAT
GCACTTGCCGCGGGAGGCA -> CACTTGCCGCGGGAGGCAA
GCACTTGCCGCTCGTTACT -> CACTTGCCGCTCGTTACTA
GCACTTGCCGGACCTCGGT -> CACTTGCCGGACCTCGGTC
GCACTTGCCGTGCCGTTAG -> CACTTGCCGTGCCGTTAGA
GCAGAATCTGTTGGAGAGC -> CAGAATCTGTTGGAGAGCT
GCAGAATTAGATTCGGTCC -> CAGAATTAGATTCGGTCCT
GCAGATGGCCCTTAAGCTG -> CAGATGGCCCTTAAGCTGG
GCAGCTTTCGCGGCCCGTA -> CAGCTTTCGCGGCCCGTAC
GCAGGGGTTGAATTCGTCC -> CAGGGGTTGAATTCGTCCT
GCAGTGAACTCACAGTTTA -> CAGTGAACTCACAGTTTAA
GCATAGCATGACAGATGTA -> CATAGCATGACAGATGTAA
GCATCTGCCTTCATTCGTC -> CATCTGCCTTCATTCGTCA
GCATGACAGATGTAAGTGT -> CATGACAGATGTAAGTGTT
GCATGTGTAAATCCCAGAC -> CATGTGTAAATCCCAGACT
GCATTAAGGGGTACACGGG -> CATTAAGGGGTACACGGGT
GCATTTGAAGACCTACAGA -> CATTTGAAGACCTACAGAC
GCATTTTTGTCCGGGGGGT -> CATTTTTGTCCGGGGGGTA
GCCAACAGTAAAACCATGT -> CCAACAGTAAAACCATGTT
GCCAATAACGGGTGGTTTA -> CCAATAACGGGTGGTTTAT
GCCAATACACCGTGATCAG -> CCAATACACCGTGATCAGA
GCCAATCGCTACCTTTACT -> CCAATCGCTACCTTTACTC
GCCAGAGGAGTGGAGATAT -> CCAGAGGAGTGGAGATATA
GCCAGGCGAACTCAGTCAT -> CCAGGCGAACTCAGTCATT
GCCATGTCTTAGCTGAGCA -> CCATGTCTTAGCTGAGCAC
GCCCACCGAACAACCGGAG -> CCCACCGAACAACCGGAGG
GCCCCCCGGCCCGGCCAAT -> CCCCCCGGCCCGGCCAATC
GCCCCCTGTGGATTATTCC -> CCCCCTGTGGATTATTCCC
GCCCCCTTGCATGTGTAAA -> CCCCCTTGCATGTGTAAAT
GCCCGAAGGCGATCATGCG -> CCCGAAGGCGATCATGCGT
GCCCGACTTTGTAATTGTT -> CCCGACTTTGTAATTGTTT
GCCCGCAATTCGGCACCCT -> CCCGCAATTCGGCACCCTG
GCCCGGCCAATCGCTACCT -> CCCGGCCAATCGCTACCTT
GCCCGTACGGGGACATGTT -> CCCGTACGGGGACATGTTG
GCCCTAGAAAAAATCTCCC -> CCCTAGAAAAAATCTCCCT
GCCCTCAACCATTAAAAAT -> CCCTCAACCATTAAAAATT
GCCCTGTGGATTATTCCCC -> CCCTGTGGATTATTCCCCG
GCCCTTAAGCTGGCTATTC -> CCCTTAAGCTGGCTATTCG
GCCCTTTCGTATCTGAGCG -> CCCTTTCGTATCTGAGCGG
GCCGCGACGAAGTTTCCCG -> CCGCGACGAAGTTTCCCGT
GCCGCGGGAGGCAAAAGAT -> CCGCGGGAGGCAAAAGATT
GCCGCTCGTTACTACCTGG -> CCGCTCGTTACTACCTGGT
GCCGGACCTCGGTCCTACT -> CCGGACCTCGGTCCTACTC
GCCGGCTAGCTTGCCAGGC -> CCGGCTAGCTTGCCAGGCG
GCCGGCTGACACAAGACGA -> CCGGCTGACACAAGACGAA
GCCGGGCACAATTACATTC -> CCGGGCACAATTACATTCA
GCCGTGCCGTTAGAACGAC -> CCGTGCCGTTAGAACGACA
GCCGTTAGAACGACAAGAC -> CCGTTAGAACGACAAGACG
GCCGTTGATCGACGGGGTA -> CCGTTGATCGACGGGGTAT
GCCTATCAGAACGCCCTCA -> CCTATCAGAACGCCCTCAA
GCCTGGGAGCACCCTGTGG -> CCTGGGAGCACCCTGTGGA
GCCTTAAGGCTCGGTGAGC -> CCTTAAGGCTCGGTGAGCG
GCCTTCATTCGTCAAGCCC -> CCTTCATTCGTCAAGCCCG
GCCTTTAAAACCAAACCGT -> CCTTTAAAACCAAACCGTG
GCGAACTCAGTCATTCATC -> CGAACTCAGTCATTCATCA
GCGACGAAGTTTCCCGTAG -> CGACGAAGTTTCCCGTAGA
GCGAGAGACACTCTTCAGA -> CGAGAGACACTCTTCAGAC
GCGAGCTCCTGCGCCCGAA -> CGAGCTCCTGCGCCCGAAG
GCGATCATGCGTTACGTAA -> CGATCATGCGTTACGTAAT
GCGATGGACTTCGAATCAC -> CGATGGACTTCGAATCACA
GCGATTTCCACTGTGCGTA -> CGATTTCCACTGTGCGTAG
GCGCAGTGAACTCACAGTT -> CGCAGTGAACTCACAGTTT
GCGCCCGAAGGCGATCATG -> CGCCCGAAGGCGATCATGC
GCGCCCGCAATTCGGCACC -> CGCCCGCAATTCGGCACCC
GCGCCGGCTGACACAAGAC -> CGCCGGCTGACACAAGACG
GCGGCCCGTACGGGGACAT -> CGGCCCGTACGGGGACATG
GCGGCCGTTGATCGACGGG -> CGGCCGTTGATCGACGGGG
GCGGCGGCCGTTGATCGAC -> CGGCGGCCGTTGATCGACG
GCGGGAGGCAAAAGATTGA -> CGGGAGGCAAAAGATTGAG
GCGGGTGACGCACCTCACA -> CGGGTGACGCACCTCACAG
GCGGTGCGTAGAGTTGGAG -> CGGTGCGTAGAGTTGGAGT
GCGGTGGCATTAAGGGGTA -> CGGTGGCATTAAGGGGTAC
GCGGTTATCACAAGTTCGG -> CGGTTATCACAAGTTCGGC
GCGTAGACGGACTTATTGG -> CGTAGACGGACTTATTGGG
GCGTAGAGTTGGAGTGTAC -> CGTAGAGTTGGAGTGTACG
GCGTGCCAATAACGGGTGG -> CGTGCCAATAACGGGTGGT
GCGTTACGTAATGCAAAGC -> CGTTACGTAATGCAAAGCG
GCGTTAGAGCATCTGCCTT -> CGTTAGAGCATCTGCCTTC
GCGTTGCACTCAGTAAAGC -> CGTTGCACTCAGTAAAGCG
GCGTTTAATCCTCAGGGTC -> CGTTTAATCCTCAGGGTCA
GCTAAGAATAGGTTGTAGA -> CTAAGAATAGGTTGTAGAA
GCTAATAGGGAGACTTCCA -> CTAATAGGGAGACTTCCAG
GCTACCTTTACTCCTAACC -> CTACCTTTACTCCTAACCT
GCTAGATTAGGGGACGGAT -> CTAGATTAGGGGACGGATT
GCTAGCTTGCCAGGCGAAC -> CTAGCTTGCCAGGCGAACT
GCTAGTTGGATGCTGTTGG -> CTAGTTGGATGCTGTTGGT
GCTATTCGTACGGCAGGGG -> CTATTCGTACGGCAGGGGT
GCTCACGCCCTGTGGATTA -> CTCACGCCCTGTGGATTAT
GCTCATTCAAAGAACACCA -> CTCATTCAAAGAACACCAA
GCTCCAAGTGTCTGGCCAG -> CTCCAAGTGTCTGGCCAGA
GCTCCATCTTCACAGTCAC -> CTCCATCTTCACAGTCACA
GCTCCTGCGCCCGAAGGCG -> CTCCTGCGCCCGAAGGCGA
GCTCGATCGTAAGCGATTT -> CTCGATCGTAAGCGATTTC
GCTCGGTGAGCGGTTATCA -> CTCGGTGAGCGGTTATCAC
GCTCGTTACTACCTGGTTT -> CTCGTTACTACCTGGTTTT
GCTGACACAAGACGAAATC -> CTGACACAAGACGAAATCC
GCTGAGCACTTGCCGCGGG -> CTGAGCACTTGCCGCGGGA
GCTGAGCACTTGCCGCTCG -> CTGAGCACTTGCCGCTCGT
GCTGAGCACTTGCCGGACC -> CTGAGCACTTGCCGGACCT
GCTGAGCACTTGCCGTGCC -> CTGAGCACTTGCCGTGCCG
GCTGCAAAGGCCTATCAGA -> CTGCAAAGGCCTATCAGAA
GCTGGCGTTAGAGCATCTG -> CTGGCGTTAGAGCATCTGC
GCTGGCTATTCGTACGGCA -> CTGGCTATTCGTACGGCAG
GCTGGTGGTATCATTATGC -> CTGGTGGTATCATTATGCC
GCTGTACTTCAGTTCTAGC -> CTGTACTTCAGTTCTAGCC
GCTGTGTCAGGGATTGGGG -> CTGTGTCAGGGATTGGGGG
GCTGTTGGTAAGTATCTAT -> CTGTTGGTAAGTATCTATA
GCTTAGCTGAGCACTTGCC -> CTTAGCTGAGCACTTGCCG,CTTAGCTGAGCACTTGCCG
GCTTAGGGGTCTAAGTGTG -> CTTAGGGGTCTAAGTGTGC
GCTTGCCAGGCGAACTCAG -> CTTGCCAGGCGAACTCAGT
GCTTTAGTCAAGAGCATTT -> CTTTAGTCAAGAGCATTTT
GCTTTCGCGGCCCGTACGG -> CTTTCGCGGCCCGTACGGG
GGAAACTTAGACAAAACCT -> GAAACTTAGACAAAACCTA
GGAAAGGCCCTTTCGTATC -> GAAAGGCCCTTTCGTATCT
GGAAGCAGCTTTCGCGGCC -> GAAGCAGCTTTCGCGGCCC
GGACACATTGAGTCGCGCA -> GACACATTGAGTCGCGCAG
GGACAGTCGTTCTTGGTTG -> GACAGTCGTTCTTGGTTGC
GGACATGTTGCCCCCCGGC -> GACATGTTGCCCCCCGGCC
GGACCACTTATATCGATTA -> GACCACTTATATCGATTAT
GGACCAGTAAGAGACACCA -> GACCAGTAAGAGACACCAG
GGACCTCGGTCCTACTCCG -> GACCTCGGTCCTACTCCGC
GGACGCGCCGGCTGACACA -> GACGCGCCGGCTGACACAA
GGACGGATTTCCTTTTGGT -> GACGGATTTCCTTTTGGTT
GGACTTATTGGGCCTTTAA -> GACTTATTGGGCCTTTAAA
GGACTTCGAATCACAATTT -> GACTTCGAATCACAATTTT
GGAGACTTCCAGATGTCTA -> GAGACTTCCAGATGTCTAG
GGAGAGCTGTGTCAGGGAT -> GAGAGCTGTGTCAGGGATT
GGAGATATAATCCTAGAAA -> GAGATATAATCCTAGAAAG
GGAGCACCCTGTGGATTAT -> GAGCACCCTGTGGATTATT
GGAGGCAAAAGATTGAGGC -> GAGGCAAAAGATTGAGGCT
GGAGGGCTCACGCCCTGTG -> GAGGGCTCACGCCCTGTGG
GGAGGGGACCAGTAAGAGA -> GAGGGGACCAGTAAGAGAC
GGAGGTCGAGTAGTGTGGA -> GAGGTCGAGTAGTGTGGAT
GGAGTGCGGTGGCATTAAG -> GAGTGCGGTGGCATTAAGG
GGAGTGGAGATATAATCCT -> GAGTGGAGATATAATCCTA
GGATACTATATCTAGGGAA -> GATACTATATCTAGGGAAG
GGATCACGGCCCACCGAAC -> GATCACGGCCCACCGAACA
GGATGCTGTTGGTAAGTAT -> GATGCTGTTGGTAAGTATC
GGATGTAAGGGGATTTAGC -> GATGTAAGGGGATTTAGCC
GGATGTAGGAAAGGCCCTT -> GATGTAGGAAAGGCCCTTT
GGATTACATTGTCTAAGGT -> GATTACATTGTCTAAGGTT
GGATTATTCCCCACTCGCC -> GATTATTCCCCACTCGCCA
GGATTATTCCCCCATCAGA -> GATTATTCCCCCATCAGAG
GGATTATTCCCCGGTGTGA -> GATTATTCCCCGGTGTGAA
GGATTATTCCCCTACTCCC -> GATTATTCCCCTACTCCCC
GGATTGGGGGGCAAAGTTC -> GATTGGGGGGCAAAGTTCA
GGATTTAGCCGCGACGAAG -> GATTTAGCCGCGACGAAGT
GGATTTCCTTTTGGTTATA -> GATTTCCTTTTGGTTATAT
GGCAAAAGATTGAGGCTAG -> GCAAAAGATTGAGGCTAGT
GGCAAAGTTCATGGCTGTA -> GCAAAGTTCATGGCTGTAC
GGCAAGGTGGTGATGTGCA -> GCAAGGTGGTGATGTGCAA
GGCACAATTACATTCAGCG -> GCACAATTACATTCAGCGT
GGCACCCTGGCACGGTAAC -> GCACCCTGGCACGGTAACA
GGCACGGTAACACGTAGTA -> GCACGGTAACACGTAGTAA
GGCAGATGGCCCTTAAGCT -> GCAGATGGCCCTTAAGCTG
GGCAGGGGTTGAATTCGTC -> GCAGGGGTTGAATTCGTCC
GGCATTAAGGGGTACACGG -> GCATTAAGGGGTACACGGG
GGCCAATCGCTACCTTTAC -> GCCAATCGCTACCTTTACT
GGCCAGAGGAGTGGAGATA -> GCCAGAGGAGTGGAGATAT
GGCCCACCGAACAACCGGA -> GCCCACCGAACAACCGGAG
GGCCCGGCCAATCGCTACC -> GCCCGGCCAATCGCTACCT
GGCCCGTACGGGGACATGT -> GCCCGTACGGGGACATGTT
GGCCCTTAAGCTGGCTATT -> GCCCTTAAGCTGGCTATTC
GGCCCTTTCGTATCTGAGC -> GCCCTTTCGTATCTGAGCG
GGCCGTTGATCGACGGGGT -> GCCGTTGATCGACGGGGTA
GGCCTATCAGAACGCCCTC -> GCCTATCAGAACGCCCTCA
GGCCTGGGAGCACCCTGTG -> GCCTGGGAGCACCCTGTGG
GGCCTTTAAAACCAAACCG -> GCCTTTAAAACCAAACCGT
GGCGAACTCAGTCATTCAT -> GCGAACTCAGTCATTCATC
GGCGAGAGACACTCTTCAG -> GCGAGAGACACTCTTCAGA
GGCGAGCTCCTGCGCCCGA -> GCGAGCTCCTGCGCCCGAA
GGCGATCATGCGTTACGTA -> GCGATCATGCGTTACGTAA
GGCGGCCGTTGATCGACGG -> GCGGCCGTTGATCGACGGG
GGCGGTGCGTAGAGTTGGA -> GCGGTGCGTAGAGTTGGAG
GGCGTTAGAGCATCTGCCT -> GCGTTAGAGCATCTGCCTT
GGCGTTGCACTCAGTAAAG -> GCGTTGCACTCAGTAAAGC
GGCTAGATTAGGGGACGGA -> GCTAGATTAGGGGACGGAT
GGCTAGCTTGCCAGGCGAA -> GCTAGCTTGCCAGGCGAAC
GGCTAGTTGGATGCTGTTG -> GCTAGTTGGATGCTGTTGG
GGCTATTCGTACGGCAGGG -> GCTATTCGTACGGCAGGGG
GGCTCACGCCCTGTGGATT -> GCTCACGCCCTGTGGATTA
GGCTCCATCTTCACAGTCA -> GCTCCATCTTCACAGTCAC
GGCTCGGTGAGCGGTTATC -> GCTCGGTGAGCGGTTATCA
GGCTGACACAAGACGAAAT -> GCTGACACAAGACGAAATC
GGCTGCAAAGGCCTATCAG -> GCTGCAAAGGCCTATCAGA
GGCTGGTGGTATCATTATG -> GCTGGTGGTATCATTATGC
GGCTGTACTTCAGTTCTAG -> GCTGTACTTCAGTTCTAGC
GGCTTAGCTGAGCACTTGC -> GCTTAGCTGAGCACTTGCC
GGGAAGCAGCTTTCGCGGC -> GGAAGCAGCTTTCGCGGCC
GGGACATGTTGCCCCCCGG -> GGACATGTTGCCCCCCGGC
GGGACCAGTAAGAGACACC -> GGACCAGTAAGAGACACCA
GGGACGGATTTCCTTTTGG -> GGACGGATTTCCTTTTGGT
GGGAGACTTCCAGATGTCT -> GGAGACTTCCAGATGTCTA
GGGAGCACCCTGTGGATTA -> GGAGCACCCTGTGGATTAT
GGGAGGCAAAAGATTGAGG -> GGAGGCAAAAGATTGAGGC
GGGAGGGGACCAGTAAGAG -> GGAGGGGACCAGTAAGAGA
GGGATGTAAGGGGATTTAG -> GGATGTAAGGGGATTTAGC
GGGATGTAGGAAAGGCCCT -> GGATGTAGGAAAGGCCCTT
GGGATTGGGGGGCAAAGTT -> GGATTGGGGGGCAAAGTTC
GGGATTTAGCCGCGACGAA -> GGATTTAGCCGCGACGAAG
GGGCAAAGTTCATGGCTGT -> GGCAAAGTTCATGGCTGTA
GGGCACAATTACATTCAGC -> GGCACAATTACATTCAGCG
GGGCCTTTAAAACCAAACC -> GGCCTTTAAAACCAAACCG
GGGCGGTGCGTAGAGTTGG -> GGCGGTGCGTAGAGTTGGA
GGGCTCACGCCCTGTGGAT -> GGCTCACGCCCTGTGGATT
GGGGACATGTTGCCCCCCG -> GGGACATGTTGCCCCCCGG
GGGGACCAGTAAGAGACAC -> GGGACCAGTAAGAGACACC
GGGGACGGATTTCCTTTTG -> GGGACGGATTTCCTTTTGG
GGGGATGTAAGGGGATTTA -> GGGATGTAAGGGGATTTAG
GGGGATTTAGCCGCGACGA -> GGGATTTAGCCGCGACGAA
GGGGCAAAGTTCATGGCTG -> GGGCAAAGTTCATGGCTGT
GGGGGCAAAGTTCATGGCT -> GGGGCAAAGTTCATGGCTG
GGGGGGCAAAGTTCATGGC -> GGGGGCAAAGTTCATGGCT
GGGGGGTATAATCACGTCA -> GGGGGTATAATCACGTCAT
GGGGGTATAATCACGTCAT -> GGGGTATAATCACGTCATT
GGGGTACACGGGTGGTGAC -> GGGTACACGGGTGGTGACT
GGGGTATAATCACGTCATT -> GGGTATAATCACGTCATTA
GGGGTATTGCCCTAGAAAA -> GGGTATTGCCCTAGAAAAA
GGGGTCTAAGTGTGCTAAG -> GGGTCTAAGTGTGCTAAGA
GGGGTTGAATTCGTCCTTC -> GGGTTGAATTCGTCCTTCC
GGGTACACGGGTGGTGACT -> GGTACACGGGTGGTGACTT
GGGTATAATCACGTCATTA -> GGTATAATCACGTCATTAT
GGGTATTGCCCTAGAAAAA -> GGTATTGCCCTAGAAAAAA
GGGTCAAGGCTCCATCTTC -> GGTCAAGGCTCCATCTTCA
GGGTCGACATCAACAATCC -> GGTCGACATCAACAATCCT
GGGTCTAAGTGTGCTAAGA -> GGTCTAAGTGTGCTAAGAA
GGGTGACGCACCTCACAGC -> GGTGACGCACCTCACAGCC
GGGTGGTGACTTGGGCGGT -> GGTGGTGACTTGGGCGGTG
GGGTGGTTTATCGGGGATG -> GGTGGTTTATCGGGGATGT
GGGTTGAATTCGTCCTTCC -> GGTTGAATTCGTCCTTCCT
GGTAACACGTAGTAAACAA -> GTAACACGTAGTAAACAAC
GGTAAGGCGAGAGACACTC -> GTAAGGCGAGAGACACTCT
GGTAAGTATCTATATCTTA -> GTAAGTATCTATATCTTAG
GGTACACGGGTGGTGACTT -> GTACACGGGTGGTGACTTG
GGTATAATCACGTCATTAT -> GTATAATCACGTCATTATG
GGTATCATTATGCCGGCTA -> GTATCATTATGCCGGCTAG
GGTATTGCCCTAGAAAAAA -> GTATTGCCCTAGAAAAAAT
GGTCAAGGCTCCATCTTCA -> GTCAAGGCTCCATCTTCAC
GGTCCTACTCCGCATAGCA -> GTCCTACTCCGCATAGCAT
GGTCCTAGAACGTATAAAG -> GTCCTAGAACGTATAAAGT
GGTCCTTTGGATTACATTG -> GTCCTTTGGATTACATTGT
GGTCGACATCAACAATCCT -> GTCGACATCAACAATCCTC
GGTCGAGTAGTGTGGATAC -> GTCGAGTAGTGTGGATACT
GGTCGTCAATCAATTCGGA -> GTCGTCAATCAATTCGGAC
GGTCTAAGTGTGCTAAGAA -> GTCTAAGTGTGCTAAGAAT
GGTGACGCACCTCACAGCC -> GTGACGCACCTCACAGCCA
GGTGACTTGGGCGGTGCGT -> GTGACTTGGGCGGTGCGTA
GGTGAGCGGTTATCACAAG -> GTGAGCGGTTATCACAAGT
GGTGATGTGCAACACAGGT -> GTGATGTGCAACACAGGTG
GGTGCGTAGAGTTGGAGTG -> GTGCGTAGAGTTGGAGTGT
GGTGGCATTAAGGGGTACA -> GTGGCATTAAGGGGTACAC
GGTGGCTGCAAAGGCCTAT -> GTGGCTGCAAAGGCCTATC
GGTGGTATCATTATGCCGG -> GTGGTATCATTATGCCGGC
GGTGGTGACTTGGGCGGTG -> GTGGTGACTTGGGCGGTGC
GGTGGTGATGTGCAACACA -> GTGGTGATGTGCAACACAG
GGTGGTGGCTGCAAAGGCC -> GTGGTGGCTGCAAAGGCCT
GGTGGTTTATCGGGGATGT -> GTGGTTTATCGGGGATGTA
GGTGTACGCTCATTCAAAG -> GTGTACGCTCATTCAAAGA
GGTGTGAAGATCTTAGCTG -> GTGTGAAGATCTTAGCTGA
GGTTAATTCCTAGTATGTT -> GTTAATTCCTAGTATGTTG
GGTTATATTAGACCTATTC -> GTTATATTAGACCTATTCC
GGTTATCACAAGTTCGGCC -> GTTATCACAAGTTCGGCCT
GGTTGAATTCGTCCTTCCT -> GTTGAATTCGTCCTTCCTA
GGTTGCAGAATCTGTTGGA -> GTTGCAGAATCTGTTGGAG
GGTTGCTTAGGGGTCTAAG -> GTTGCTTAGGGGTCTAAGT
GGTTGTAGAATTTTGGAAA -> GTTGTAGAATTTTGGAAAC
GGTTTATCGGGGATGTAAG -> GTTTATCGGGGATGTAAGG
GGTTTTGGCTGGTGGTATC -> GTTTTGGCTGGTGGTATCA
GTAAAACCATGTTCATCCT -> TAAAACCATGTTCATCCTG
GTAAACAACGGTCCTTTGG -> TAAACAACGGTCCTTTGGA
GTAAAGCGCCCGCAATTCG -> TAAAGCGCCCGCAATTCGG
GTAAATCCCAGACTAGAGA -> TAAATCCCAGACTAGAGAT
GTAACACGTAGTAAACAAC -> TAACACGTAGTAAACAACG
GTAAGAGACACCAGGAGTG -> TAAGAGACACCAGGAGTGC
GTAAGCCAACAGTAAAACC -> TAAGCCAACAGTAAAACCA
GTAAGCGATTTCCACTGTG -> TAAGCGATTTCCACTGTGC
GTAAGGCGAGAGACACTCT -> TAAGGCGAGAGACACTCTT
GTAAGGGGATTTAGCCGCG -> TAAGGGGATTTAGCCGCGA
GTAAGTATCTATATCTTAG -> TAAGTATCTATATCTTAGC
GTAAGTGTTGGTCGTCAAT -> TAAGTGTTGGTCGTCAATC
GTAATGCAAAGCGTTTAAT -> TAATGCAAAGCGTTTAATC
GTAATTGTTTCGCTTTAGT -> TAATTGTTTCGCTTTAGTC
GTACACGGGTGGTGACTTG -> TACACGGGTGGTGACTTGG
GTACGATTATCGCGGGTGA -> TACGATTATCGCGGGTGAC
GTACGCTCATTCAAAGAAC -> TACGCTCATTCAAAGAACA
GTACGGCAGGGGTTGAATT -> TACGGCAGGGGTTGAATTC
GTACGGGGACATGTTGCCC -> TACGGGGACATGTTGCCCC
GTACTGTTGACAATCGCTA -> TACTGTTGACAATCGCTAA
GTACTTCAGTTCTAGCCTT -> TACTTCAGTTCTAGCCTTA
GTAGAATTTTGGAAACTTA -> TAGAATTTTGGAAACTTAG
GTAGACATGAAACGTACTG -> TAGACATGAAACGTACTGT
GTAGACGGACTTATTGGGC -> TAGACGGACTTATTGGGCC
GTAGAGTTGGAGTGTACGC -> TAGAGTTGGAGTGTACGCA
GTAGATACTTCCTGATCGT -> TAGATACTTCCTGATCGTA
GTAGCAAGTCTCGGGATGT -> TAGCAAGTCTCGGGATGTA
GTAGGAAAGGCCCTTTCGT -> TAGGAAAGGCCCTTTCGTA
GTAGTAAACAACGGTCCTT -> TAGTAAACAACGGTCCTTT
GTAGTCTTCGTGTAAGCCA -> TAGTCTTCGTGTAAGCCAA
GTAGTGTGGATACTATATC -> TAGTGTGGATACTATATCT
GTATAAAGTGGCAAGGTGG -> TATAAAGTGGCAAGGTGGT
GTATAATCACGTCATTATG -> TATAATCACGTCATTATGC
GTATCATTATGCCGGCTAG -> TATCATTATGCCGGCTAGC
GTATCTATATCTTAGCCGG -> TATCTATATCTTAGCCGGG
GTATCTGAGCGGCGGCCGT -> TATCTGAGCGGCGGCCGTT
GTATGTTGACGGTTGCAGA -> TATGTTGACGGTTGCAGAA
GTATTGCCCTAGAAAAAAT -> TATTGCCCTAGAAAAAATC
GTCAAGAGCATTTTTGTCC -> TCAAGAGCATTTTTGTCCG
GTCAAGCCCGACTTTGTAA -> TCAAGCCCGACTTTGTAAT
GTCAAGGCTCCATCTTCAC -> TCAAGGCTCCATCTTCACA
GTCAATCAATTCGGACCAC -> TCAATCAATTCGGACCACT
GTCACACGCAGAATTAGAT -> TCACACGCAGAATTAGATT
GTCAGGGATTGGGGGGCAA -> TCAGGGATTGGGGGGCAAA
GTCATTATGCCCCCTTGCA -> TCATTATGCCCCCTTGCAT
GTCATTCATCATATATATC -> TCATTCATCATATATATCC
GTCCAAAAACGGTAAGGCG -> TCCAAAAACGGTAAGGCGA
GTCCGGGGGGTATAATCAC -> TCCGGGGGGTATAATCACG
GTCCTACTCCGCATAGCAT -> TCCTACTCCGCATAGCATG
GTCCTAGAACGTATAAAGT -> TCCTAGAACGTATAAAGTG
GTCCTGTAGTCTTCGTGTA -> TCCTGTAGTCTTCGTGTAA
GTCCTTCCTATCAATGCGA -> TCCTTCCTATCAATGCGAT
GTCCTTTGGATTACATTGT -> TCCTTTGGATTACATTGTC
GTCGACATCAACAATCCTC -> TCGACATCAACAATCCTCA
GTCGAGTAGTGTGGATACT -> TCGAGTAGTGTGGATACTA
GTCGCGCAGTGAACTCACA -> TCGCGCAGTGAACTCACAG
GTCGTCAATCAATTCGGAC -> TCGTCAATCAATTCGGACC
GTCGTTCTTGGTTGCTTAG -> TCGTTCTTGGTTGCTTAGG
GTCTAAGGTTAATTCCTAG -> TCTAAGGTTAATTCCTAGT
GTCTAAGTGTGCTAAGAAT -> TCTAAGTGTGCTAAGAATA
GTCTAGGACGCGCCGGCTG -> TCTAGGACGCGCCGGCTGA
GTCTCGGACACATTGAGTC -> TCTCGGACACATTGAGTCG
GTCTCGGGATGTAGGAAAG -> TCTCGGGATGTAGGAAAGG
GTCTGGCCAGAGGAGTGGA -> TCTGGCCAGAGGAGTGGAG
GTCTTAGCTGAGCACTTGC -> TCTTAGCTGAGCACTTGCC
GTCTTCGTGTAAGCCAACA -> TCTTCGTGTAAGCCAACAG
GTGAACTCACAGTTTAATC -> TGAACTCACAGTTTAATCA
GTGAAGATCTTAGCTGAGC -> TGAAGATCTTAGCTGAGCA
GTGACCCACTAGAATTCTG -> TGACCCACTAGAATTCTGT
GTGACGCACCTCACAGCCA -> TGACGCACCTCACAGCCAA
GTGACTTGGGCGGTGCGTA -> TGACTTGGGCGGTGCGTAG
GTGAGCGGTTATCACAAGT -> TGAGCGGTTATCACAAGTT
GTGATCAGACCTGCTCCAA -> TGATCAGACCTGCTCCAAG
GTGATGTGCAACACAGGTG -> TGATGTGCAACACAGGTGT
GTGCAACACAGGTGTACGC -> TGCAACACAGGTGTACGCT
GTGCATTTGAAGACCTACA -> TGCATTTGAAGACCTACAG
GTGCCAATAACGGGTGGTT -> TGCCAATAACGGGTGGTTT
GTGCCGTTAGAACGACAAG -> TGCCGTTAGAACGACAAGA
GTGCGGTGGCATTAAGGGG -> TGCGGTGGCATTAAGGGGT
GTGCGTAGACGGACTTATT -> TGCGTAGACGGACTTATTG
GTGCGTAGAGTTGGAGTGT -> TGCGTAGAGTTGGAGTGTA
GTGCTAAGAATAGGTTGTA -> TGCTAAGAATAGGTTGTAG
GTGGAGATATAATCCTAGA -> TGGAGATATAATCCTAGAA
GTGGATACTATATCTAGGG -> TGGATACTATATCTAGGGA
GTGGATTATTCCCCACTCG -> TGGATTATTCCCCACTCGC
GTGGATTATTCCCCCATCA -> TGGATTATTCCCCCATCAG
GTGGATTATTCCCCGGTGT -> TGGATTATTCCCCGGTGTG
GTGGATTATTCCCCTACTC -> TGGATTATTCCCCTACTCC
GTGGCAAGGTGGTGATGTG -> TGGCAAGGTGGTGATGTGC
GTGGCATTAAGGGGTACAC -> TGGCATTAAGGGGTACACG
GTGGCGAGCTCCTGCGCCC -> TGGCGAGCTCCTGCGCCCG
GTGGCTGCAAAGGCCTATC -> TGGCTGCAAAGGCCTATCA
GTGGTATCATTATGCCGGC -> TGGTATCATTATGCCGGCT
GTGGTGACTTGGGCGGTGC -> TGGTGACTTGGGCGGTGCG
GTGGTGATGTGCAACACAG -> TGGTGATGTGCAACACAGG
GTGGTGGCTGCAAAGGCCT -> TGGTGGCTGCAAAGGCCTA
GTGGTTTATCGGGGATGTA -> TGGTTTATCGGGGATGTAA
GTGTAAATCCCAGACTAGA -> TGTAAATCCCAGACTAGAG
GTGTAAGCCAACAGTAAAA -> TGTAAGCCAACAGTAAAAC
GTGTACGCTCATTCAAAGA -> TGTACGCTCATTCAAAGAA
GTGTCAGGGATTGGGGGGC -> TGTCAGGGATTGGGGGGCA
GTGTCTGGCCAGAGGAGTG -> TGTCTGGCCAGAGGAGTGG
GTGTGAAGATCTTAGCTGA -> TGTGAAGATCTTAGCTGAG
GTGTGCTAAGAATAGGTTG -> TGTGCTAAGAATAGGTTGT
GTGTGGATACTATATCTAG -> TGTGGATACTATATCTAGG
GTGTTGGTCGTCAATCAAT -> TGTTGGTCGTCAATCAATT
GTTAATTCCTAGTATGTTG -> TTAATTCCTAGTATGTTGA
GTTACGTAATGCAAAGCGT -> TTACGTAATGCAAAGCGTT
GTTACTACCTGGTTTTGGC -> TTACTACCTGGTTTTGGCT
GTTAGAACGACAAGACGTG -> TTAGAACGACAAGACGTGC
GTTAGAGCATCTGCCTTCA -> TTAGAGCATCTGCCTTCAT
GTTATATTAGACCTATTCC -> TTATATTAGACCTATTCCC
GTTATCACAAGTTCGGCCT -> TTATCACAAGTTCGGCCTG
GTTCATCCTGACACTCGAA -> TTCATCCTGACACTCGAAA
GTTCATGGCTGTACTTCAG -> TTCATGGCTGTACTTCAGT
GTTCGGCAGATGGCCCTTA -> TTCGGCAGATGGCCCTTAA
GTTCGGCCTGGGAGCACCC -> TTCGGCCTGGGAGCACCCT
GTTCTAGCCTTAAGGCTCG -> TTCTAGCCTTAAGGCTCGG
GTTCTGCACATAGAAGGAC -> TTCTGCACATAGAAGGACA
GTTCTTGGTTGCTTAGGGG -> TTCTTGGTTGCTTAGGGGT
GTTGAATTCGTCCTTCCTA -> TTGAATTCGTCCTTCCTAT
GTTGACAATCGCTAATAGG -> TTGACAATCGCTAATAGGG
GTTGACGGTTGCAGAATCT -> TTGACGGTTGCAGAATCTG
GTTGATCGACGGGGTATTG -> TTGATCGACGGGGTATTGC
GTTGCACTCAGTAAAGCGC -> TTGCACTCAGTAAAGCGCC
GTTGCAGAATCTGTTGGAG -> TTGCAGAATCTGTTGGAGA
GTTGCCCCCCGGCCCGGCC -> TTGCCCCCCGGCCCGGCCA
GTTGCTTAGGGGTCTAAGT -> TTGCTTAGGGGTCTAAGTG
GTTGGAGAGCTGTGTCAGG -> TTGGAGAGCTGTGTCAGGG
GTTGGATGCTGTTGGTAAG -> TTGGATGCTGTTGGTAAGT
GTTGGTAAGTATCTATATC -> TTGGTAAGTATCTATATCT
GTTGGTCGTCAATCAATTC -> TTGGTCGTCAATCAATTCG
GTTGTAGAATTTTGGAAAC -> TTGTAGAATTTTGGAAACT
GTTTAATCATAAAAACAAA -> TTTAATCATAAAAACAAAA
GTTTAATCCTCAGGGTCAA -> TTTAATCCTCAGGGTCAAG
GTTTATCGGGGATGTAAGG -> TTTATCGGGGATGTAAGGG
GTTTCCCGTAGATACTTCC -> TTTCCCGTAGATACTTCCT
GTTTCGCTTTAGTCAAGAG -> TTTCGCTTTAGTCAAGAGC
GTTTTGGCTGGTGGTATCA -> TTTTGGCTGGTGGTATCAT
TAAAAACAAAATAGCCCCC -> AAAAACAAAATAGCCCCCT
TAAAAATTTCTACGTCCTG -> AAAAATTTCTACGTCCTGT
TAAAACCAAACCGTGGCGA -> AAAACCAAACCGTGGCGAG
TAAAACCATGTTCATCCTG -> AAAACCATGTTCATCCTGA
TAAACAACGGTCCTTTGGA -> AAACAACGGTCCTTTGGAT
TAAAGCGCCCGCAATTCGG -> AAAGCGCCCGCAATTCGGC
TAAAGTGGCAAGGTGGTGA -> AAAGTGGCAAGGTGGTGAT
TAAATCCCAGACTAGAGAT -> AAATCCCAGACTAGAGATG
TAACACGTAGTAAACAACG -> AACACGTAGTAAACAACGG
TAACCTTAGCTGGCGTTAG -> AACCTTAGCTGGCGTTAGA
TAACGGGTGGTTTATCGGG -> AACGGGTGGTTTATCGGGG
TAAGAATAGGTTGTAGAAT -> AAGAATAGGTTGTAGAATT
TAAGAGACACCAGGAGTGC -> AAGAGACACCAGGAGTGCG
TAAGCCAACAGTAAAACCA -> AAGCCAACAGTAAAACCAT
TAAGCGATTTCCACTGTGC -> AAGCGATTTCCACTGTGCG
TAAGCTGGCTATTCGTACG -> AAGCTGGCTATTCGTACGG
TAAGGCGAGAGACACTCTT -> AAGGCGAGAGACACTCTTC
TAAGGCTCGGTGAGCGGTT -> AAGGCTCGGTGAGCGGTTA
TAAGGGGATTTAGCCGCGA -> AAGGGGATTTAGCCGCGAC
TAAGGGGTACACGGGTGGT -> AAGGGGTACACGGGTGGTG
TAAGGTTAATTCCTAGTAT -> AAGGTTAATTCCTAGTATG
TAAGTATCTATATCTTAGC -> AAGTATCTATATCTTAGCC
TAAGTGTGCTAAGAATAGG -> AAGTGTGCTAAGAATAGGT
TAAGTGTTGGTCGTCAATC -> AAGTGTTGGTCGTCAATCA
TAATAGGGAGACTTCCAGA -> AATAGGGAGACTTCCAGAT
TAATCACGTCATTATGCCC -> AATCACGTCATTATGCCCC
TAATCATAAAAACAAAATA -> AATCATAAAAACAAAATAG
TAATCCTAGAAAGATGTAG -> AATCCTAGAAAGATGTAGA
TAATCCTCAGGGTCAAGGC -> AATCCTCAGGGTCAAGGCT
TAATGCAAAGCGTTTAATC -> AATGCAAAGCGTTTAATCC
TAATTCCTAGTATGTTGAC -> AATTCCTAGTATGTTGACG
TAATTGTTTCGCTTTAGTC -> AATTGTTTCGCTTTAGTCA
TACACCGTGATCAGACCTG -> ACACCGTGATCAGACCTGC
TACACGGGTGGTGACTTGG -> ACACGGGTGGTGACTTGGG
TACAGACGGCGTTGCACTC -> ACAGACGGCGTTGCACTCA
TACATTCAGCGTGCCAATA -> ACATTCAGCGTGCCAATAA
TACATTGTCTAAGGTTAAT -> ACATTGTCTAAGGTTAATT
TACCCTTGGGAGGGGACCA -> ACCCTTGGGAGGGGACCAG
TACCTGGTTTTGGCTGGTG -> ACCTGGTTTTGGCTGGTGG
TACCTTTACTCCTAACCTT -> ACCTTTACTCCTAACCTTA
TACGATTATCGCGGGTGAC -> ACGATTATCGCGGGTGACG
TACGCTCATTCAAAGAACA -> ACGCTCATTCAAAGAACAC
TACGGCAGGGGTTGAATTC -> ACGGCAGGGGTTGAATTCG
TACGGGGACATGTTGCCCC -> ACGGGGACATGTTGCCCCC
TACGTAATGCAAAGCGTTT -> ACGTAATGCAAAGCGTTTA
TACGTCCTGTAGTCTTCGT -> ACGTCCTGTAGTCTTCGTG
TACTACCTGGTTTTGGCTG -> ACTACCTGGTTTTGGCTGG
TACTATATCTAGGGAAGCA -> ACTATATCTAGGGAAGCAG
TACTCCCCAGGCTTAGCTG -> ACTCCCCAGGCTTAGCTGA
TACTCCGCATAGCATGACA -> ACTCCGCATAGCATGACAG
TACTCCTAACCTTAGCTGG -> ACTCCTAACCTTAGCTGGC
TACTGTTGACAATCGCTAA -> ACTGTTGACAATCGCTAAT
TACTTCAGTTCTAGCCTTA -> ACTTCAGTTCTAGCCTTAA
TACTTCCTGATCGTACGAT -> ACTTCCTGATCGTACGATT
TAGAAAAAATCTCCCTGTG -> AGAAAAAATCTCCCTGTGG
TAGAAAGATGTAGACATGA -> AGAAAGATGTAGACATGAA
TAGAACGACAAGACGTGCA -> AGAACGACAAGACGTGCAT
TAGAACGTATAAAGTGGCA -> AGAACGTATAAAGTGGCAA
TAGAAGGACAGTCGTTCTT -> AGAAGGACAGTCGTTCTTG
TAGAATTCTGTAGCAAGTC -> AGAATTCTGTAGCAAGTCT
TAGAATTTTGGAAACTTAG -> AGAATTTTGGAAACTTAGA
TAGACAAAACCTAGAGTTC -> AGACAAAACCTAGAGTTCG
TAGACATGAAACGTACTGT -> AGACATGAAACGTACTGTT
TAGACCTATTCCCCTTATG -> AGACCTATTCCCCTTATGG
TAGACGGACTTATTGGGCC -> AGACGGACTTATTGGGCCT
TAGAGATGCACTGTGACCC -> AGAGATGCACTGTGACCCA
TAGAGCATCTGCCTTCATT -> AGAGCATCTGCCTTCATTC
TAGAGTTCGGCAGATGGCC -> AGAGTTCGGCAGATGGCCC
TAGAGTTGGAGTGTACGCA -> AGAGTTGGAGTGTACGCAA
TAGATACTTCCTGATCGTA -> AGATACTTCCTGATCGTAC
TAGATTAGGGGACGGATTT -> AGATTAGGGGACGGATTTC
TAGATTCGGTCCTAGAACG -> AGATTCGGTCCTAGAACGT
TAGCAAGTCTCGGGATGTA -> AGCAAGTCTCGGGATGTAG
TAGCATGACAGATGTAAGT -> AGCATGACAGATGTAAGTG
TAGCCCCCTGTGGATTATT -> AGCCCCCTGTGGATTATTC
TAGCCGCGACGAAGTTTCC -> AGCCGCGACGAAGTTTCCC
TAGCCGGGCACAATTACAT -> AGCCGGGCACAATTACATT
TAGCCTTAAGGCTCGGTGA -> AGCCTTAAGGCTCGGTGAG
TAGCTGAGCACTTGCCGCG -> AGCTGAGCACTTGCCGCGG
TAGCTGAGCACTTGCCGCT -> AGCTGAGCACTTGCCGCTC
TAGCTGAGCACTTGCCGGA -> AGCTGAGCACTTGCCGGAC
TAGCTGAGCACTTGCCGTG -> AGCTGAGCACTTGCCGTGC
TAGCTGGCGTTAGAGCATC -> AGCTGGCGTTAGAGCATCT
TAGCTTGCCAGGCGAACTC -> AGCTTGCCAGGCGAACTCA
TAGGAAAGGCCCTTTCGTA -> AGGAAAGGCCCTTTCGTAT
TAGGACGCGCCGGCTGACA -> AGGACGCGCCGGCTGACAC
TAGGGAAGCAGCTTTCGCG -> AGGGAAGCAGCTTTCGCGG
TAGGGAGACTTCCAGATGT -> AGGGAGACTTCCAGATGTC
TAGGGGACGGATTTCCTTT -> AGGGGACGGATTTCCTTTT
TAGGGGTCTAAGTGTGCTA -> AGGGGTCTAAGTGTGCTAA
TAGGTTGTAGAATTTTGGA -> AGGTTGTAGAATTTTGGAA
TAGTAAACAACGGTCCTTT -> AGTAAACAACGGTCCTTTG
TAGTATGTTGACGGTTGCA -> AGTATGTTGACGGTTGCAG
TAGTCAAGAGCATTTTTGT -> AGTCAAGAGCATTTTTGTC
TAGTCTTCGTGTAAGCCAA -> AGTCTTCGTGTAAGCCAAC
TAGTGTGGATACTATATCT -> AGTGTGGATACTATATCTA
TAGTTGGATGCTGTTGGTA -> AGTTGGATGCTGTTGGTAA
TATAAAGTGGCAAGGTGGT -> ATAAAGTGGCAAGGTGGTG
TATAATCACGTCATTATGC -> ATAATCACGTCATTATGCC
TATAATCCTAGAAAGATGT -> ATAATCCTAGAAAGATGTA
TATATATCCCCGAATTCGC -> ATATATCCCCGAATTCGCT
TATATCCCCGAATTCGCTC -> ATATCCCCGAATTCGCTCG
TATATCGATTATCTTGGGT -> ATATCGATTATCTTGGGTC
TATATCTAGGGAAGCAGCT -> ATATCTAGGGAAGCAGCTT
TATATCTTAGCCGGGCACA -> ATATCTTAGCCGGGCACAA
TATATTAGACCTATTCCCC -> ATATTAGACCTATTCCCCT
TATCAATGCGATGGACTTC -> ATCAATGCGATGGACTTCG
TATCACAAGTTCGGCCTGG -> ATCACAAGTTCGGCCTGGG
TATCAGAACGCCCTCAACC -> ATCAGAACGCCCTCAACCA
TATCATTATGCCGGCTAGC -> ATCATTATGCCGGCTAGCT
TATCCCCGAATTCGCTCGA -> ATCCCCGAATTCGCTCGAT
TATCGATTATCTTGGGTCG -> ATCGATTATCTTGGGTCGA
TATCGCGGGTGACGCACCT -> ATCGCGGGTGACGCACCTC
TATCGGGGATGTAAGGGGA -> ATCGGGGATGTAAGGGGAT
TATCTAGGGAAGCAGCTTT -> ATCTAGGGAAGCAGCTTTC
TATCTATATCTTAGCCGGG -> ATCTATATCTTAGCCGGGC
TATCTGAGCGGCGGCCGTT -> ATCTGAGCGGCGGCCGTTG
TATCTTAGCCGGGCACAAT -> ATCTTAGCCGGGCACAATT
TATCTTGGGTCGACATCAA -> ATCTTGGGTCGACATCAAC
TATGCCCCCTTGCATGTGT -> ATGCCCCCTTGCATGTGTA
TATGCCGGCTAGCTTGCCA -> ATGCCGGCTAGCTTGCCAG
TATGGTGGTGGCTGCAAAG -> ATGGTGGTGGCTGCAAAGG
TATGTTGACGGTTGCAGAA -> ATGTTGACGGTTGCAGAAT
TATTAGACCTATTCCCCTT -> ATTAGACCTATTCCCCTTA
TATTCCCCACTCGCCATGT -> ATTCCCCACTCGCCATGTC
TATTCCCCCATCAGAGAAG -> ATTCCCCCATCAGAGAAGC
TATTCCCCGGTGTGAAGAT -> ATTCCCCGGTGTGAAGATC
TATTCCCCTACTCCCCAGG -> ATTCCCCTACTCCCCAGGC
TATTCCCCTTATGGTGGTG -> ATTCCCCTTATGGTGGTGG
TATTCGTACGGCAGGGGTT -> ATTCGTACGGCAGGGGTTG
TATTGCCCTAGAAAAAATC -> ATTGCCCTAGAAAAAATCT
TATTGGGCCTTTAAAACCA -> ATTGGGCCTTTAAAACCAA
TCAAAGAACACCAAGGAGG -> CAAAGAACACCAAGGAGGT
TCAACAATCCTCACCCGTC -> CAACAATCCTCACCCGTCC
TCAACCATTAAAAATTTCT -> CAACCATTAAAAATTTCTA
TCAAGAGCATTTTTGTCCG -> CAAGAGCATTTTTGTCCGG
TCAAGCCCGACTTTGTAAT -> CAAGCCCGACTTTGTAATT
TCAAGGCTCCATCTTCACA -> CAAGGCTCCATCTTCACAG
TCAATCAATTCGGACCACT -> CAATCAATTCGGACCACTT
TCAATGCGATGGACTTCGA -> CAATGCGATGGACTTCGAA
TCAATTCGGACCACTTATA -> CAATTCGGACCACTTATAT
TCACAAGTTCGGCCTGGGA -> CACAAGTTCGGCCTGGGAG
TCACAATTTTTTACCCTTG -> CACAATTTTTTACCCTTGG
TCACACGCAGAATTAGATT -> CACACGCAGAATTAGATTC
TCACAGCCAATACACCGTG -> CACAGCCAATACACCGTGA
TCACAGTCACACGCAGAAT -> CACAGTCACACGCAGAATT
TCACAGTTTAATCATAAAA -> CACAGTTTAATCATAAAAA
TCACATCCAACCGGCTAGA -> CACATCCAACCGGCTAGAT
TCACCCGTCCAAAAACGGT -> CACCCGTCCAAAAACGGTA
TCACGCCCTGTGGATTATT -> CACGCCCTGTGGATTATTC
TCACGGCCCACCGAACAAC -> CACGGCCCACCGAACAACC
TCACGTCATTATGCCCCCT -> CACGTCATTATGCCCCCTT
TCAGAACGCCCTCAACCAT -> CAGAACGCCCTCAACCATT
TCAGACCTGCTCCAAGTGT -> CAGACCTGCTCCAAGTGTC
TCAGACTCGTTCTGCACAT -> CAGACTCGTTCTGCACATA
TCAGAGAAGCTTAGCTGAG -> CAGAGAAGCTTAGCTGAGC
TCAGCGTGCCAATAACGGG -> CAGCGTGCCAATAACGGGT
TCAGGGATTGGGGGGCAAA -> CAGGGATTGGGGGGCAAAG
TCAGGGTCAAGGCTCCATC -> CAGGGTCAAGGCTCCATCT
TCAGTAAAGCGCCCGCAAT -> CAGTAAAGCGCCCGCAATT
TCAGTCATTCATCATATAT -> CAGTCATTCATCATATATA
TCAGTTCTAGCCTTAAGGC -> CAGTTCTAGCCTTAAGGCT
TCATAAAAACAAAATAGCC -> CATAAAAACAAAATAGCCC
TCATATATATCCCCGAATT -> CATATATATCCCCGAATTC
TCATCATATATATCCCCGA -> CATCATATATATCCCCGAA
TCATCCTGACACTCGAAAG -> CATCCTGACACTCGAAAGA
TCATGCGTTACGTAATGCA -> CATGCGTTACGTAATGCAA
TCATGGCTGTACTTCAGTT -> CATGGCTGTACTTCAGTTC
TCATTATGCCCCCTTGCAT -> CATTATGCCCCCTTGCATG
TCATTATGCCGGCTAGCTT -> CATTATGCCGGCTAGCTTG
TCATTCAAAGAACACCAAG -> CATTCAAAGAACACCAAGG
TCATTCATCATATATATCC -> CATTCATCATATATATCCC
TCATTCGTCAAGCCCGACT -> CATTCGTCAAGCCCGACTT
TCCAAAAACGGTAAGGCGA -> CCAAAAACGGTAAGGCGAG
TCCAACCGGCTAGATTAGG -> CCAACCGGCTAGATTAGGG
TCCAAGTGTCTGGCCAGAG -> CCAAGTGTCTGGCCAGAGG
TCCACTGTGCGTAGACGGA -> CCACTGTGCGTAGACGGAC
TCCAGATGTCTAGGACGCG -> CCAGATGTCTAGGACGCGC
TCCATCTTCACAGTCACAC -> CCATCTTCACAGTCACACG
TCCCAGACTAGAGATGCAC -> CCCAGACTAGAGATGCACT
TCCCCACTCGCCATGTCTT -> CCCCACTCGCCATGTCTTA
TCCCCAGGCTTAGCTGAGC -> CCCCAGGCTTAGCTGAGCA
TCCCCCATCAGAGAAGCTT -> CCCCCATCAGAGAAGCTTA
TCCCCGAATTCGCTCGATC -> CCCCGAATTCGCTCGATCG
TCCCCGGTGTGAAGATCTT -> CCCCGGTGTGAAGATCTTA
TCCCCTACTCCCCAGGCTT -> CCCCTACTCCCCAGGCTTA
TCCCCTTATGGTGGTGGCT -> CCCCTTATGGTGGTGGCTG
TCCCGTAGATACTTCCTGA -> CCCGTAGATACTTCCTGAT
TCCCTGTCTCGGACACATT -> CCCTGTCTCGGACACATTG
TCCCTGTGGATTATTCCCC -> CCCTGTGGATTATTCCCCT
TCCGCATAGCATGACAGAT -> CCGCATAGCATGACAGATG
TCCGGGGGGTATAATCACG -> CCGGGGGGTATAATCACGT
TCCTAACCTTAGCTGGCGT -> CCTAACCTTAGCTGGCGTT
TCCTACTCCGCATAGCATG -> CCTACTCCGCATAGCATGA
TCCTAGAAAGATGTAGACA -> CCTAGAAAGATGTAGACAT
TCCTAGAACGTATAAAGTG -> CCTAGAACGTATAAAGTGG
TCCTAGTATGTTGACGGTT -> CCTAGTATGTTGACGGTTG
TCCTATCAATGCGATGGAC -> CCTATCAATGCGATGGACT
TCCTCACCCGTCCAAAAAC -> CCTCACCCGTCCAAAAACG
TCCTCAGGGTCAAGGCTCC -> CCTCAGGGTCAAGGCTCCA
TCCTGACACTCGAAAGAAC -> CCTGACACTCGAAAGAACG
TCCTGATCGTACGATTATC -> CCTGATCGTACGATTATCG
TCCTGCGCCCGAAGGCGAT -> CCTGCGCCCGAAGGCGATC
TCCTGTAGTCTTCGTGTAA -> CCTGTAGTCTTCGTGTAAG
TCCTTCCTATCAATGCGAT -> CCTTCCTATCAATGCGATG
TCCTTTGGATTACATTGTC -> CCTTTGGATTACATTGTCT
TCCTTTTGGTTATATTAGA -> CCTTTTGGTTATATTAGAC
TCGAAAGAACGGATCACGG -> CGAAAGAACGGATCACGGC
TCGAATCACAATTTTTTAC -> CGAATCACAATTTTTTACC
TCGACATCAACAATCCTCA -> CGACATCAACAATCCTCAC
TCGACGGGGTATTGCCCTA -> CGACGGGGTATTGCCCTAG
TCGAGTAGTGTGGATACTA -> CGAGTAGTGTGGATACTAT
TCGATCGTAAGCGATTTCC -> CGATCGTAAGCGATTTCCA
TCGATTATCTTGGGTCGAC -> CGATTATCTTGGGTCGACA
TCGCCATGTCTTAGCTGAG -> CGCCATGTCTTAGCTGAGC
TCGCGCAGTGAACTCACAG -> CGCGCAGTGAACTCACAGT
TCGCGGCCCGTACGGGGAC -> CGCGGCCCGTACGGGGACA
TCGCGGGTGACGCACCTCA -> CGCGGGTGACGCACCTCAC
TCGCTAATAGGGAGACTTC -> CGCTAATAGGGAGACTTCC
TCGCTACCTTTACTCCTAA -> CGCTACCTTTACTCCTAAC
TCGCTCGATCGTAAGCGAT -> CGCTCGATCGTAAGCGATT
TCGCTTTAGTCAAGAGCAT -> CGCTTTAGTCAAGAGCATT
TCGGACACATTGAGTCGCG -> CGGACACATTGAGTCGCGC
TCGGACCACTTATATCGAT -> CGGACCACTTATATCGATT
TCGGCACCCTGGCACGGTA -> CGGCACCCTGGCACGGTAA
TCGGCAGATGGCCCTTAAG -> CGGCAGATGGCCCTTAAGC
TCGGCCTGGGAGCACCCTG -> CGGCCTGGGAGCACCCTGT
TCGGGATGTAGGAAAGGCC -> CGGGATGTAGGAAAGGCCC
TCGGGGATGTAAGGGGATT -> CGGGGATGTAAGGGGATTT
TCGGTCCTACTCCGCATAG -> CGGTCCTACTCCGCATAGC
TCGGTCCTAGAACGTATAA -> CGGTCCTAGAACGTATAAA
TCGGTGAGCGGTTATCACA -> CGGTGAGCGGTTATCACAA
TCGTAAGCGATTTCCACTG -> CGTAAGCGATTTCCACTGT
TCGTACGATTATCGCGGGT -> CGTACGATTATCGCGGGTG
TCGTACGGCAGGGGTTGAA -> CGTACGGCAGGGGTTGAAT
TCGTATCTGAGCGGCGGCC -> CGTATCTGAGCGGCGGCCG
TCGTCAAGCCCGACTTTGT -> CGTCAAGCCCGACTTTGTA
TCGTCAATCAATTCGGACC -> CGTCAATCAATTCGGACCA
TCGTCCTTCCTATCAATGC -> CGTCCTTCCTATCAATGCG
TCGTGTAAGCCAACAGTAA -> CGTGTAAGCCAACAGTAAA
TCGTTACTACCTGGTTTTG -> CGTTACTACCTGGTTTTGG
TCGTTCTGCACATAGAAGG -> CGTTCTGCACATAGAAGGA
TCGTTCTTGGTTGCTTAGG -> CGTTCTTGGTTGCTTAGGG
TCTAAGGTTAATTCCTAGT -> CTAAGGTTAATTCCTAGTA
TCTAAGTGTGCTAAGAATA -> CTAAGTGTGCTAAGAATAG
TCTACGTCCTGTAGTCTTC -> CTACGTCCTGTAGTCTTCG
TCTAGCCTTAAGGCTCGGT -> CTAGCCTTAAGGCTCGGTG
TCTAGGACGCGCCGGCTGA -> CTAGGACGCGCCGGCTGAC
TCTAGGGAAGCAGCTTTCG -> CTAGGGAAGCAGCTTTCGC
TCTATATCTTAGCCGGGCA -> CTATATCTTAGCCGGGCAC
TCTCCCTGTGGATTATTCC -> CTCCCTGTGGATTATTCCC
TCTCGGACACATTGAGTCG -> CTCGGACACATTGAGTCGC
TCTCGGGATGTAGGAAAGG -> CTCGGGATGTAGGAAAGGC
TCTGAGCGGCGGCCGTTGA -> CTGAGCGGCGGCCGTTGAT
TCTGCACATAGAAGGACAG -> CTGCACATAGAAGGACAGT
TCTGCCTTCATTCGTCAAG -> CTGCCTTCATTCGTCAAGC
TCTGGCCAGAGGAGTGGAG -> CTGGCCAGAGGAGTGGAGA
TCTGTAGCAAGTCTCGGGA -> CTGTAGCAAGTCTCGGGAT
TCTGTTGGAGAGCTGTGTC -> CTGTTGGAGAGCTGTGTCA
TCTTAGCCGGGCACAATTA -> CTTAGCCGGGCACAATTAC
TCTTAGCTGAGCACTTGCC -> CTTAGCTGAGCACTTGCCG,CTTAGCTGAGCACTTGCCG
TCTTCACAGTCACACGCAG -> CTTCACAGTCACACGCAGA
TCTTCAGACTCGTTCTGCA -> CTTCAGACTCGTTCTGCAC
TCTTCGTGTAAGCCAACAG -> CTTCGTGTAAGCCAACAGT
TCTTGGGTCGACATCAACA -> CTTGGGTCGACATCAACAA
TCTTGGTTGCTTAGGGGTC -> CTTGGTTGCTTAGGGGTCT
TGAAACGTACTGTTGACAA -> GAAACGTACTGTTGACAAT
TGAACTCACAGTTTAATCA -> GAACTCACAGTTTAATCAT
TGAAGACCTACAGACGGCG -> GAAGACCTACAGACGGCGT
TGAAGATCTTAGCTGAGCA -> GAAGATCTTAGCTGAGCAC
TGAATTCGTCCTTCCTATC -> GAATTCGTCCTTCCTATCA
TGACAATCGCTAATAGGGA -> GACAATCGCTAATAGGGAG
TGACACAAGACGAAATCCC -> GACACAAGACGAAATCCCT
TGACACTCGAAAGAACGGA -> GACACTCGAAAGAACGGAT
TGACAGATGTAAGTGTTGG -> GACAGATGTAAGTGTTGGT
TGACCCACTAGAATTCTGT -> GACCCACTAGAATTCTGTA
TGACGCACCTCACAGCCAA -> GACGCACCTCACAGCCAAT
TGACGGTTGCAGAATCTGT -> GACGGTTGCAGAATCTGTT
TGACTTGGGCGGTGCGTAG -> GACTTGGGCGGTGCGTAGA
TGAGCACTTGCCGCGGGAG -> GAGCACTTGCCGCGGGAGG
TGAGCACTTGCCGCTCGTT -> GAGCACTTGCCGCTCGTTA
TGAGCACTTGCCGGACCTC -> GAGCACTTGCCGGACCTCG
TGAGCACTTGCCGTGCCGT -> GAGCACTTGCCGTGCCGTT
TGAGCGGCGGCCGTTGATC -> GAGCGGCGGCCGTTGATCG
TGAGCGGTTATCACAAGTT -> GAGCGGTTATCACAAGTTC
TGAGGCTAGTTGGATGCTG -> GAGGCTAGTTGGATGCTGT
TGAGTCGCGCAGTGAACTC -> GAGTCGCGCAGTGAACTCA
TGATCAGACCTGCTCCAAG -> GATCAGACCTGCTCCAAGT
TGATCGACGGGGTATTGCC -> GATCGACGGGGTATTGCCC
TGATCGTACGATTATCGCG -> GATCGTACGATTATCGCGG
TGATGTGCAACACAGGTGT -> GATGTGCAACACAGGTGTA
TGCAAAGCGTTTAATCCTC -> GCAAAGCGTTTAATCCTCA
TGCAAAGGCCTATCAGAAC -> GCAAAGGCCTATCAGAACG
TGCAACACAGGTGTACGCT -> GCAACACAGGTGTACGCTC
TGCACATAGAAGGACAGTC -> GCACATAGAAGGACAGTCG
TGCACTCAGTAAAGCGCCC -> GCACTCAGTAAAGCGCCCG
TGCACTGTGACCCACTAGA -> GCACTGTGACCCACTAGAA
TGCAGAATCTGTTGGAGAG -> GCAGAATCTGTTGGAGAGC
TGCATGTGTAAATCCCAGA -> GCATGTGTAAATCCCAGAC
TGCATTTGAAGACCTACAG -> GCATTTGAAGACCTACAGA
TGCCAATAACGGGTGGTTT -> GCCAATAACGGGTGGTTTA
TGCCAGGCGAACTCAGTCA -> GCCAGGCGAACTCAGTCAT
TGCCCCCCGGCCCGGCCAA -> GCCCCCCGGCCCGGCCAAT
TGCCCCCTTGCATGTGTAA -> GCCCCCTTGCATGTGTAAA
TGCCCTAGAAAAAATCTCC -> GCCCTAGAAAAAATCTCCC
TGCCGCGGGAGGCAAAAGA -> GCCGCGGGAGGCAAAAGAT
TGCCGCTCGTTACTACCTG -> GCCGCTCGTTACTACCTGG
TGCCGGACCTCGGTCCTAC -> GCCGGACCTCGGTCCTACT
TGCCGGCTAGCTTGCCAGG -> GCCGGCTAGCTTGCCAGGC
TGCCGTGCCGTTAGAACGA -> GCCGTGCCGTTAGAACGAC
TGCCGTTAGAACGACAAGA -> GCCGTTAGAACGACAAGAC
TGCCTTCATTCGTCAAGCC -> GCCTTCATTCGTCAAGCCC
TGCGATGGACTTCGAATCA -> GCGATGGACTTCGAATCAC
TGCGCCCGAAGGCGATCAT -> GCGCCCGAAGGCGATCATG
TGCGGTGGCATTAAGGGGT -> GCGGTGGCATTAAGGGGTA
TGCGTAGACGGACTTATTG -> GCGTAGACGGACTTATTGG
TGCGTAGAGTTGGAGTGTA -> GCGTAGAGTTGGAGTGTAC
TGCGTTACGTAATGCAAAG -> GCGTTACGTAATGCAAAGC
TGCTAAGAATAGGTTGTAG -> GCTAAGAATAGGTTGTAGA
TGCTCCAAGTGTCTGGCCA -> GCTCCAAGTGTCTGGCCAG
TGCTGTTGGTAAGTATCTA -> GCTGTTGGTAAGTATCTAT
TGCTTAGGGGTCTAAGTGT -> GCTTAGGGGTCTAAGTGTG
TGGAAACTTAGACAAAACC -> GGAAACTTAGACAAAACCT
TGGACTTCGAATCACAATT -> GGACTTCGAATCACAATTT
TGGAGAGCTGTGTCAGGGA -> GGAGAGCTGTGTCAGGGAT
TGGAGATATAATCCTAGAA -> GGAGATATAATCCTAGAAA
TGGATACTATATCTAGGGA -> GGATACTATATCTAGGGAA
TGGATGCTGTTGGTAAGTA -> GGATGCTGTTGGTAAGTAT
TGGATTACATTGTCTAAGG -> GGATTACATTGTCTAAGGT
TGGATTATTCCCCACTCGC -> GGATTATTCCCCACTCGCC
TGGATTATTCCCCCATCAG -> GGATTATTCCCCCATCAGA
TGGATTATTCCCCGGTGTG -> GGATTATTCCCCGGTGTGA
TGGATTATTCCCCTACTCC -> GGATTATTCCCCTACTCCC
TGGCAAGGTGGTGATGTGC -> GGCAAGGTGGTGATGTGCA
TGGCACGGTAACACGTAGT -> GGCACGGTAACACGTAGTA
TGGCATTAAGGGGTACACG -> GGCATTAAGGGGTACACGG
TGGCCAGAGGAGTGGAGAT -> GGCCAGAGGAGTGGAGATA
TGGCCCTTAAGCTGGCTAT -> GGCCCTTAAGCTGGCTATT
TGGCGAGCTCCTGCGCCCG -> GGCGAGCTCCTGCGCCCGA
TGGCGTTAGAGCATCTGCC -> GGCGTTAGAGCATCTGCCT
TGGCTATTCGTACGGCAGG -> GGCTATTCGTACGGCAGGG
TGGCTGCAAAGGCCTATCA -> GGCTGCAAAGGCCTATCAG
TGGCTGGTGGTATCATTAT -> GGCTGGTGGTATCATTATG
TGGCTGTACTTCAGTTCTA -> GGCTGTACTTCAGTTCTAG
TGGGAGCACCCTGTGGATT -> GGGAGCACCCTGTGGATTA
TGGGAGGGGACCAGTAAGA -> GGGAGGGGACCAGTAAGAG
TGGGCCTTTAAAACCAAAC -> GGGCCTTTAAAACCAAACC
TGGGCGGTGCGTAGAGTTG -> GGGCGGTGCGTAGAGTTGG
TGGGGGGCAAAGTTCATGG -> GGGGGGCAAAGTTCATGGC
TGGGTCGACATCAACAATC -> GGGTCGACATCAACAATCC
TGGTAAGTATCTATATCTT -> GGTAAGTATCTATATCTTA
TGGTATCATTATGCCGGCT -> GGTATCATTATGCCGGCTA
TGGTCGTCAATCAATTCGG -> GGTCGTCAATCAATTCGGA
TGGTGACTTGGGCGGTGCG -> GGTGACTTGGGCGGTGCGT
TGGTGATGTGCAACACAGG -> GGTGATGTGCAACACAGGT
TGGTGGCTGCAAAGGCCTA -> GGTGGCTGCAAAGGCCTAT
TGGTGGTATCATTATGCCG -> GGTGGTATCATTATGCCGG
TGGTGGTGGCTGCAAAGGC -> GGTGGTGGCTGCAAAGGCC
TGGTTATATTAGACCTATT -> GGTTATATTAGACCTATTC
TGGTTGCTTAGGGGTCTAA -> GGTTGCTTAGGGGTCTAAG
TGGTTTATCGGGGATGTAA -> GGTTTATCGGGGATGTAAG
TGGTTTTGGCTGGTGGTAT -> GGTTTTGGCTGGTGGTATC
TGTAAATCCCAGACTAGAG -> GTAAATCCCAGACTAGAGA
TGTAAGCCAACAGTAAAAC -> GTAAGCCAACAGTAAAACC
TGTAAGGGGATTTAGCCGC -> GTAAGGGGATTTAGCCGCG
TGTAAGTGTTGGTCGTCAA -> GTAAGTGTTGGTCGTCAAT
TGTAATTGTTTCGCTTTAG -> GTAATTGTTTCGCTTTAGT
TGTACGCTCATTCAAAGAA -> GTACGCTCATTCAAAGAAC
TGTACTTCAGTTCTAGCCT -> GTACTTCAGTTCTAGCCTT
TGTAGAATTTTGGAAACTT -> GTAGAATTTTGGAAACTTA
TGTAGACATGAAACGTACT -> GTAGACATGAAACGTACTG
TGTAGCAAGTCTCGGGATG -> GTAGCAAGTCTCGGGATGT
TGTAGGAAAGGCCCTTTCG -> GTAGGAAAGGCCCTTTCGT
TGTAGTCTTCGTGTAAGCC -> GTAGTCTTCGTGTAAGCCA
TGTCAGGGATTGGGGGGCA -> GTCAGGGATTGGGGGGCAA
TGTCCGGGGGGTATAATCA -> GTCCGGGGGGTATAATCAC
TGTCTAAGGTTAATTCCTA -> GTCTAAGGTTAATTCCTAG
TGTCTAGGACGCGCCGGCT -> GTCTAGGACGCGCCGGCTG
TGTCTCGGACACATTGAGT -> GTCTCGGACACATTGAGTC
TGTCTGGCCAGAGGAGTGG -> GTCTGGCCAGAGGAGTGGA
TGTCTTAGCTGAGCACTTG -> GTCTTAGCTGAGCACTTGC
TGTGAAGATCTTAGCTGAG -> GTGAAGATCTTAGCTGAGC
TGTGACCCACTAGAATTCT -> GTGACCCACTAGAATTCTG
TGTGCAACACAGGTGTACG -> GTGCAACACAGGTGTACGC
TGTGCGTAGACGGACTTAT -> GTGCGTAGACGGACTTATT
TGTGCTAAGAATAGGTTGT -> GTGCTAAGAATAGGTTGTA
TGTGGATACTATATCTAGG -> GTGGATACTATATCTAGGG
TGTGGATTATTCCCCACTC -> GTGGATTATTCCCCACTCG
TGTGGATTATTCCCCCATC -> GTGGATTATTCCCCCATCA
TGTGGATTATTCCCCGGTG -> GTGGATTATTCCCCGGTGT
TGTGGATTATTCCCCTACT -> GTGGATTATTCCCCTACTC
TGTGTAAATCCCAGACTAG -> GTGTAAATCCCAGACTAGA
TGTGTCAGGGATTGGGGGG -> GTGTCAGGGATTGGGGGGC
TGTTCATCCTGACACTCGA -> GTTCATCCTGACACTCGAA
TGTTGACAATCGCTAATAG -> GTTGACAATCGCTAATAGG
TGTTGACGGTTGCAGAATC -> GTTGACGGTTGCAGAATCT
TGTTGCCCCCCGGCCCGGC -> GTTGCCCCCCGGCCCGGCC
TGTTGGAGAGCTGTGTCAG -> GTTGGAGAGCTGTGTCAGG
TGTTGGTAAGTATCTATAT -> GTTGGTAAGTATCTATATC
TGTTGGTCGTCAATCAATT -> GTTGGTCGTCAATCAATTC
TGTTTCGCTTTAGTCAAGA -> GTTTCGCTTTAGTCAAGAG
TTAAAAATTTCTACGTCCT -> TAAAAATTTCTACGTCCTG
TTAAAACCAAACCGTGGCG -> TAAAACCAAACCGTGGCGA
TTAAGCTGGCTATTCGTAC -> TAAGCTGGCTATTCGTACG
TTAAGGCTCGGTGAGCGGT -> TAAGGCTCGGTGAGCGGTT
TTAAGGGGTACACGGGTGG -> TAAGGGGTACACGGGTGGT
TTAATCATAAAAACAAAAT -> TAATCATAAAAACAAAATA
TTAATCCTCAGGGTCAAGG -> TAATCCTCAGGGTCAAGGC
TTAATTCCTAGTATGTTGA -> TAATTCCTAGTATGTTGAC
TTACATTCAGCGTGCCAAT -> TACATTCAGCGTGCCAATA
TTACATTGTCTAAGGTTAA -> TACATTGTCTAAGGTTAAT
TTACCCTTGGGAGGGGACC -> TACCCTTGGGAGGGGACCA
TTACGTAATGCAAAGCGTT -> TACGTAATGCAAAGCGTTT
TTACTACCTGGTTTTGGCT -> TACTACCTGGTTTTGGCTG
TTACTCCTAACCTTAGCTG -> TACTCCTAACCTTAGCTGG
TTAGAACGACAAGACGTGC -> TAGAACGACAAGACGTGCA
TTAGACAAAACCTAGAGTT -> TAGACAAAACCTAGAGTTC
TTAGACCTATTCCCCTTAT -> TAGACCTATTCCCCTTATG
TTAGAGCATCTGCCTTCAT -> TAGAGCATCTGCCTTCATT
TTAGATTCGGTCCTAGAAC -> TAGATTCGGTCCTAGAACG
TTAGCCGCGACGAAGTTTC -> TAGCCGCGACGAAGTTTCC
TTAGCCGGGCACAATTACA -> TAGCCGGGCACAATTACAT
TTAGCTGAGCACTTGCCGC -> TAGCTGAGCACTTGCCGCG,TAGCTGAGCACTTGCCGCT
TTAGCTGAGCACTTGCCGG -> TAGCTGAGCACTTGCCGGA
TTAGCTGAGCACTTGCCGT -> TAGCTGAGCACTTGCCGTG
TTAGCTGGCGTTAGAGCAT -> TAGCTGGCGTTAGAGCATC
TTAGGGGACGGATTTCCTT -> TAGGGGACGGATTTCCTTT
TTAGGGGTCTAAGTGTGCT -> TAGGGGTCTAAGTGTGCTA
TTAGTCAAGAGCATTTTTG -> TAGTCAAGAGCATTTTTGT
TTATATCGATTATCTTGGG -> TATATCGATTATCTTGGGT
TTATATTAGACCTATTCCC -> TATATTAGACCTATTCCCC
TTATCACAAGTTCGGCCTG -> TATCACAAGTTCGGCCTGG
TTATCGCGGGTGACGCACC -> TATCGCGGGTGACGCACCT
TTATCGGGGATGTAAGGGG -> TATCGGGGATGTAAGGGGA
TTATCTTGGGTCGACATCA -> TATCTTGGGTCGACATCAA
TTATGCCCCCTTGCATGTG -> TATGCCCCCTTGCATGTGT
TTATGCCGGCTAGCTTGCC -> TATGCCGGCTAGCTTGCCA
TTATGGTGGTGGCTGCAAA -> TATGGTGGTGGCTGCAAAG
TTATTCCCCACTCGCCATG -> TATTCCCCACTCGCCATGT
TTATTCCCCCATCAGAGAA -> TATTCCCCCATCAGAGAAG
TTATTCCCCGGTGTGAAGA -> TATTCCCCGGTGTGAAGAT
TTATTCCCCTACTCCCCAG -> TATTCCCCTACTCCCCAGG
TTATTGGGCCTTTAAAACC -> TATTGGGCCTTTAAAACCA
TTCAAAGAACACCAAGGAG -> TCAAAGAACACCAAGGAGG
TTCACAGTCACACGCAGAA -> TCACAGTCACACGCAGAAT
TTCAGACTCGTTCTGCACA -> TCAGACTCGTTCTGCACAT
TTCAGCGTGCCAATAACGG -> TCAGCGTGCCAATAACGGG
TTCAGTTCTAGCCTTAAGG -> TCAGTTCTAGCCTTAAGGC
TTCATCATATATATCCCCG -> TCATCATATATATCCCCGA
TTCATCCTGACACTCGAAA -> TCATCCTGACACTCGAAAG
TTCATGGCTGTACTTCAGT -> TCATGGCTGTACTTCAGTT
TTCATTCGTCAAGCCCGAC -> TCATTCGTCAAGCCCGACT
TTCCACTGTGCGTAGACGG -> TCCACTGTGCGTAGACGGA
TTCCAGATGTCTAGGACGC -> TCCAGATGTCTAGGACGCG
TTCCCCACTCGCCATGTCT -> TCCCCACTCGCCATGTCTT
TTCCCCCATCAGAGAAGCT -> TCCCCCATCAGAGAAGCTT
TTCCCCGGTGTGAAGATCT -> TCCCCGGTGTGAAGATCTT
TTCCCCTACTCCCCAGGCT -> TCCCCTACTCCCCAGGCTT
TTCCCCTTATGGTGGTGGC -> TCCCCTTATGGTGGTGGCT
TTCCCGTAGATACTTCCTG -> TCCCGTAGATACTTCCTGA
TTCCTAGTATGTTGACGGT -> TCCTAGTATGTTGACGGTT
TTCCTATCAATGCGATGGA -> TCCTATCAATGCGATGGAC
TTCCTGATCGTACGATTAT -> TCCTGATCGTACGATTATC
TTCCTTTTGGTTATATTAG -> TCCTTTTGGTTATATTAGA
TTCGAATCACAATTTTTTA -> TCGAATCACAATTTTTTAC
TTCGCGGCCCGTACGGGGA -> TCGCGGCCCGTACGGGGAC
TTCGCTCGATCGTAAGCGA -> TCGCTCGATCGTAAGCGAT
TTCGCTTTAGTCAAGAGCA -> TCGCTTTAGTCAAGAGCAT
TTCGGACCACTTATATCGA -> TCGGACCACTTATATCGAT
TTCGGCACCCTGGCACGGT -> TCGGCACCCTGGCACGGTA
TTCGGCAGATGGCCCTTAA -> TCGGCAGATGGCCCTTAAG
TTCGGCCTGGGAGCACCCT -> TCGGCCTGGGAGCACCCTG
TTCGGTCCTAGAACGTATA -> TCGGTCCTAGAACGTATAA
TTCGTACGGCAGGGGTTGA -> TCGTACGGCAGGGGTTGAA
TTCGTATCTGAGCGGCGGC -> TCGTATCTGAGCGGCGGCC
TTCGTCAAGCCCGACTTTG -> TCGTCAAGCCCGACTTTGT
TTCGTCCTTCCTATCAATG -> TCGTCCTTCCTATCAATGC
TTCGTGTAAGCCAACAGTA -> TCGTGTAAGCCAACAGTAA
TTCTACGTCCTGTAGTCTT -> TCTACGTCCTGTAGTCTTC
TTCTAGCCTTAAGGCTCGG -> TCTAGCCTTAAGGCTCGGT
TTCTGCACATAGAAGGACA -> TCTGCACATAGAAGGACAG
TTCTGTAGCAAGTCTCGGG -> TCTGTAGCAAGTCTCGGGA
TTCTTGGTTGCTTAGGGGT -> TCTTGGTTGCTTAGGGGTC
TTGAAGACCTACAGACGGC -> TGAAGACCTACAGACGGCG
TTGAATTCGTCCTTCCTAT -> TGAATTCGTCCTTCCTATC
TTGACAATCGCTAATAGGG -> TGACAATCGCTAATAGGGA
TTGACGGTTGCAGAATCTG -> TGACGGTTGCAGAATCTGT
TTGAGGCTAGTTGGATGCT -> TGAGGCTAGTTGGATGCTG
TTGAGTCGCGCAGTGAACT -> TGAGTCGCGCAGTGAACTC
TTGATCGACGGGGTATTGC -> TGATCGACGGGGTATTGCC
TTGCACTCAGTAAAGCGCC -> TGCACTCAGTAAAGCGCCC
TTGCAGAATCTGTTGGAGA -> TGCAGAATCTGTTGGAGAG
TTGCATGTGTAAATCCCAG -> TGCATGTGTAAATCCCAGA
TTGCCAGGCGAACTCAGTC -> TGCCAGGCGAACTCAGTCA
TTGCCCCCCGGCCCGGCCA -> TGCCCCCCGGCCCGGCCAA
TTGCCCTAGAAAAAATCTC -> TGCCCTAGAAAAAATCTCC
TTGCCGCGGGAGGCAAAAG -> TGCCGCGGGAGGCAAAAGA
TTGCCGCTCGTTACTACCT -> TGCCGCTCGTTACTACCTG
TTGCCGGACCTCGGTCCTA -> TGCCGGACCTCGGTCCTAC
TTGCCGTGCCGTTAGAACG -> TGCCGTGCCGTTAGAACGA
TTGCTTAGGGGTCTAAGTG -> TGCTTAGGGGTCTAAGTGT
TTGGAAACTTAGACAAAAC -> TGGAAACTTAGACAAAACC
TTGGAGAGCTGTGTCAGGG -> TGGAGAGCTGTGTCAGGGA
TTGGATGCTGTTGGTAAGT -> TGGATGCTGTTGGTAAGTA
TTGGATTACATTGTCTAAG -> TGGATTACATTGTCTAAGG
TTGGCTGGTGGTATCATTA -> TGGCTGGTGGTATCATTAT
TTGGGAGGGGACCAGTAAG -> TGGGAGGGGACCAGTAAGA
TTGGGCCTTTAAAACCAAA -> TGGGCCTTTAAAACCAAAC
TTGGGCGGTGCGTAGAGTT -> TGGGCGGTGCGTAGAGTTG
TTGGGGGGCAAAGTTCATG -> TGGGGGGCAAAGTTCATGG
TTGGGTCGACATCAACAAT -> TGGGTCGACATCAACAATC
TTGGTAAGTATCTATATCT -> TGGTAAGTATCTATATCTT
TTGGTCGTCAATCAATTCG -> TGGTCGTCAATCAATTCGG
TTGGTTATATTAGACCTAT -> TGGTTATATTAGACCTATT
TTGGTTGCTTAGGGGTCTA -> TGGTTGCTTAGGGGTCTAA
TTGTAATTGTTTCGCTTTA -> TGTAATTGTTTCGCTTTAG
TTGTAGAATTTTGGAAACT -> TGTAGAATTTTGGAAACTT
TTGTCCGGGGGGTATAATC -> TGTCCGGGGGGTATAATCA
TTGTCTAAGGTTAATTCCT -> TGTCTAAGGTTAATTCCTA
TTGTTTCGCTTTAGTCAAG -> TGTTTCGCTTTAGTCAAGA
TTTAAAACCAAACCGTGGC -> TTAAAACCAAACCGTGGCG
TTTAATCATAAAAACAAAA -> TTAATCATAAAAACAAAAT
TTTAATCCTCAGGGTCAAG -> TTAATCCTCAGGGTCAAGG
TTTACCCTTGGGAGGGGAC -> TTACCCTTGGGAGGGGACC
TTTACTCCTAACCTTAGCT -> TTACTCCTAACCTTAGCTG
TTTAGCCGCGACGAAGTTT -> TTAGCCGCGACGAAGTTTC
TTTAGTCAAGAGCATTTTT -> TTAGTCAAGAGCATTTTTG
TTTATCGGGGATGTAAGGG -> TTATCGGGGATGTAAGGGG
TTTCCACTGTGCGTAGACG -> TTCCACTGTGCGTAGACGG
TTTCCCGTAGATACTTCCT -> TTCCCGTAGATACTTCCTG
TTTCCTTTTGGTTATATTA -> TTCCTTTTGGTTATATTAG
TTTCGCGGCCCGTACGGGG -> TTCGCGGCCCGTACGGGGA
TTTCGCTTTAGTCAAGAGC -> TTCGCTTTAGTCAAGAGCA
TTTCGTATCTGAGCGGCGG -> TTCGTATCTGAGCGGCGGC
TTTCTACGTCCTGTAGTCT -> TTCTACGTCCTGTAGTCTT
TTTGAAGACCTACAGACGG -> TTGAAGACCTACAGACGGC
TTTGGAAACTTAGACAAAA -> TTGGAAACTTAGACAAAAC
TTTGGATTACATTGTCTAA -> TTGGATTACATTGTCTAAG
TTTGGCTGGTGGTATCATT -> TTGGCTGGTGGTATCATTA
TTTGGTTATATTAGACCTA -> TTGGTTATATTAGACCTAT
TTTGTAATTGTTTCGCTTT -> TTGTAATTGTTTCGCTTTA
TTTGTCCGGGGGGTATAAT -> TTGTCCGGGGGGTATAATC
TTTTACCCTTGGGAGGGGA -> TTTACCCTTGGGAGGGGAC
TTTTGGAAACTTAGACAAA -> TTTGGAAACTTAGACAAAA
TTTTGGCTGGTGGTATCAT -> TTTGGCTGGTGGTATCATT
TTTTGGTTATATTAGACCT -> TTTGGTTATATTAGACCTA
TTTTGTCCGGGGGGTATAA -> TTTGTCCGGGGGGTATAAT
TTTTTACCCTTGGGAGGGG -> TTTTACCCTTGGGAGGGGA
TTTTTGTCCGGGGGGTATA -> TTTTGTCCGGGGGGTATAA
TTTTTTACCCTTGGGAGGG -> TTTTTACCCTTGGGAGGGG
